sentence_A	sentence_B	label
pelayanan oke , kamar lumayan untuk persinggahan istirahat .	<extra_id_0> pelayanan <extra_id_1> oke <extra_id_2> positive ; <extra_id_3> kamar <extra_id_4> lumayan <extra_id_5> positive	aos
kamar yang excelent .	<extra_id_0> kamar	a
saya sudah beberapa kali tidur di hotel yang harganya 200rb'an tetapi hotel ini yang benarbenar buat tamu nya bisa buat betah di ruangan saya ada kulkas kecil jadi tambah jatuh cinta saya , kalau kurang nya sih cuma ac nya tidak full dingin dan lampu tidur di atas kasur tidak bisa di hidupkan tetapi jujur ini hotel mulai sekarang jadi langganan saya tia bulan bobo disini .	<extra_id_0> ac nya <extra_id_1> negative ; <extra_id_2> lampu tidur <extra_id_3> negative	as
seperti biasa , bersih fasilitas berfungsi semua orang nya ramah .	<extra_id_0> fasilitas <extra_id_1> bersih ; <extra_id_2> fasilitas <extra_id_3> berfungsi ; <extra_id_4> orang nya <extra_id_5> ramah	ao
lumayan , keseluruhan nyaman sayangnya , ada beberapa hal yang harus diperhatikan , kurangnya kebersihan pada kamar , ada bekas rexona di bawah kasur dari tamu awal , tetapi selebihnya luar biasa . nyaman , wifi cepat . pelayanan yang baik . terimakasih . rekomended buat backpacker yang bingung cari tempat untuk menginap , terimakasih airy . anda memang kece .	<extra_id_0> keseluruhan <extra_id_1> positive ; <extra_id_2> kebersihan <extra_id_3> negative ; <extra_id_4> selebihnya <extra_id_5> positive ; <extra_id_6> wifi <extra_id_7> positive ; <extra_id_8> pelayanan <extra_id_9> positive ; <extra_id_10> NULL <extra_id_11> positive	as
pelayanan bagus , kamar bersih , wifi kencang .	<extra_id_0> pelayanan ; <extra_id_1> kamar ; <extra_id_2> wifi	a
pelayanan oke , fasilitas big no , dikamar tidak ada keset , flapon seperti rembesan air begitu sudah lumutan , agak bau apek , ac kurang dingin , pembuangan air kamar mandi agak tersumbat , tidak rekomen lah pokok iya .	<extra_id_0> pelayanan <extra_id_1> oke <extra_id_2> positive ; <extra_id_3> fasilitas <extra_id_4> big no <extra_id_5> negative ; <extra_id_6> keset <extra_id_7> tidak ada <extra_id_8> negative ; <extra_id_9> flapon <extra_id_10> lumutan <extra_id_11> negative ; <extra_id_12> ac <extra_id_13> kurang dingin <extra_id_14> negative ; <extra_id_15> pembuangan air kamar mandi <extra_id_16> agak tersumbat <extra_id_17> negative ; <extra_id_18> NULL <extra_id_19> agak bau apek <extra_id_20> negative ; <extra_id_21> NULL <extra_id_22> tidak rekomen <extra_id_23> negative	aos
pelayanan nya ramah dan baik sekali .	<extra_id_0> pelayanan nya <extra_id_1> ramah ; <extra_id_2> pelayanan nya <extra_id_3> baik sekali	ao
kamar bersih tetapi agak bau dan asalnya dari lemari pakaian . alhasil lemari tidak kepake karena takut baunya ikut . biaya tambahan 1 orang untuk sarapan terlalu tinggi untuk ukuran hotel bintang 3 .	<extra_id_0> kamar <extra_id_1> bersih ; <extra_id_2> kamar <extra_id_3> agak bau	ao
pelayanannya ramah , roomnya bersih . letaknya strategis pusat kota .	<extra_id_0> pelayanannya <extra_id_1> positive ; <extra_id_2> roomnya <extra_id_3> positive ; <extra_id_4> letaknya <extra_id_5> positive	as
kamar nya terbilang bagus tetapi sayang perawatan nya kurang , ac nya tidak dingin , disediakan kompor tetapi tidak ada gas dan perlatan memasak dan tidak ada papan reklame airy di depan yang buat saya bingung cari lokasi nya sampai mutarmutar . terimakasih airy .	<extra_id_0> bagus ; <extra_id_1> kurang ; <extra_id_2> tidak dingin	o
baguss kamarnyaa bersih dekat dari perkotaan .	<extra_id_0> kamarnyaa <extra_id_1> positive ; <extra_id_2> NULL <extra_id_3> positive	as
pas mau breakfast soto madura sudah tidak ada dagingnya sama sekali , kuah juga keasinan , tetapi untung ada pilihan breakfast lainnya .	<extra_id_0> breakfast <extra_id_1> tidak ada dagingnya	ao
seprai dan bed cover nya seperti nya perlu di ganti karena sudah terlihat aga usang .	<extra_id_0> seprai <extra_id_1> perlu di ganti ; <extra_id_2> seprai <extra_id_3> aga usang ; <extra_id_4> bed cover nya <extra_id_5> perlu di ganti ; <extra_id_6> bed cover nya <extra_id_7> aga usang	ao
kondisi ruangan cukup baik , namun ada beberapa komponen dalam ruang tidur dan ruang mandi memerlukan perbaikan akibat kerusakan .	<extra_id_0> ruangan	a
sarapannya biasa saja , kebersihan kurang .	<extra_id_0> sarapannya <extra_id_1> biasa saja <extra_id_2> neutral ; <extra_id_3> kebersihan <extra_id_4> kurang <extra_id_5> negative	aos
kamar dibersihkan dan dirapikan setiap hari , fasilitas oke , hanya resepsionis sering tidak ada di tempat .	<extra_id_0> oke ; <extra_id_1> sering tidak ada	o
ada harga ada rupa . tanpa makan pagi tetapi dapat snack . kekurangannya , air panas kurang berfungsi di .	<extra_id_0> makan pagi <extra_id_1> negative ; <extra_id_2> snack <extra_id_3> positive ; <extra_id_4> air panas <extra_id_5> negative	as
pengelolanya ramah dan baik . tetapi kadang suka merinding banyak kamar nya tetapi tidak ada orang nya . kolam renang nya oke juga .	<extra_id_0> ramah ; <extra_id_1> baik ; <extra_id_2> oke	o
pelayanan ramah , kamar bersih dan harus lebih ditingkatkan untuk kebersihan , menu sarapan dan peralatan .	<extra_id_0> pelayanan <extra_id_1> ramah ; <extra_id_2> kamar <extra_id_3> bersih ; <extra_id_4> kebersihan <extra_id_5> harus lebih ditingkatkan	ao
lumayan . harga murmer . fasilitas standar hotel . untuk makanan agak kurang sih tetapi overall good .	<extra_id_0> harga <extra_id_1> murmer ; <extra_id_2> fasilitas <extra_id_3> standar ; <extra_id_4> makanan <extra_id_5> agak kurang ; <extra_id_6> overall <extra_id_7> good ; <extra_id_8> NULL <extra_id_9> lumayan	ao
listrik sempat mati , kasur bau .	<extra_id_0> listrik <extra_id_1> sempat mati ; <extra_id_2> kasur <extra_id_3> bau	ao
menyenangkan . dengan harga murah tetapi nyaman . cuma kurang perabotan seperti meja dan kursi .	<extra_id_0> harga <extra_id_1> murah ; <extra_id_2> perabotan <extra_id_3> kurang ; <extra_id_4> meja <extra_id_5> kurang ; <extra_id_6> kursi <extra_id_7> kurang ; <extra_id_8> NULL <extra_id_9> menyenangkan ; <extra_id_10> NULL <extra_id_11> nyaman	ao
keamanan terjaga karena ada cctv dan keamanan .	<extra_id_0> keamanan <extra_id_1> terjaga	ao
toilet bocor , sehingga ubin basah kmanakmana .	<extra_id_0> bocor	o
pelayanan nya kurang baik . tempat nya sudah oke bagus bersih .	<extra_id_0> kurang baik ; <extra_id_1> oke ; <extra_id_2> bagus ; <extra_id_3> bersih	o
bagus , rapi , pelayanan baik , tetapi airnya sangat buruk , rasa air laut .	<extra_id_0> baik ; <extra_id_1> sangat buruk ; <extra_id_2> bagus ; <extra_id_3> rapi	o
tempat nyaman . bersih . fasilitas oce . menyenangkan .	<extra_id_0> tempat ; <extra_id_1> fasilitas ; <extra_id_2> NULL	a
tempat nyaman , bersih , recomended .	<extra_id_0> tempat <extra_id_1> nyaman <extra_id_2> positive ; <extra_id_3> tempat <extra_id_4> bersih <extra_id_5> positive ; <extra_id_6> tempat <extra_id_7> recomended <extra_id_8> positive	aos
pelayanannya bagus . sampai diantar ke bandara dengan juga .	<extra_id_0> pelayanannya	a
dekat akses transportasi .	<extra_id_0> akses transportasi <extra_id_1> dekat	ao
kamar enak tidak ada masalah tetapi kamar mandi lantai 1 nomor 1 banyak kecoak .	<extra_id_0> kamar <extra_id_1> positive ; <extra_id_2> kamar mandi <extra_id_3> negative	as
ac tidak dingin , sudah 3x lapor tidak ada tanggapan sama sekali , lantai keramik banyak yang rusak .	<extra_id_0> ac <extra_id_1> tidak dingin <extra_id_2> negative ; <extra_id_3> lantai <extra_id_4> rusak <extra_id_5> negative	aos
tempatnya secara keseluruhan baik , rapi , bersih . hanya hot shower tidak tersedia .	<extra_id_0> tempatnya <extra_id_1> baik <extra_id_2> positive ; <extra_id_3> tempatnya <extra_id_4> rapi <extra_id_5> positive ; <extra_id_6> tempatnya <extra_id_7> bersih <extra_id_8> positive ; <extra_id_9> hot shower <extra_id_10> tidak tersedia <extra_id_11> negative	aos
puas menginap disini .	<extra_id_0> NULL	a
overall baik .	<extra_id_0> baik	o
kamar nyaman dan bersih . pelayanan baik .	<extra_id_0> kamar <extra_id_1> positive ; <extra_id_2> pelayanan <extra_id_3> positive	as
ac dingin , cuma deposit agak mahal . dan sarapan tidak terlalu banyak pilihan . secara keseluruhan bagus sih .	<extra_id_0> dingin ; <extra_id_1> agak mahal ; <extra_id_2> tidak terlalu banyak pilihan ; <extra_id_3> bagus	o
hotel yang lumayan , terjangkau , dekat dengan stasiun cukup jalan kaki , kemana mana juga dekat mudah di akses , sayang lagi renovasi dan kamar mandi banyak yang perlu di perbaiki .	<extra_id_0> lumayan ; <extra_id_1> terjangkau ; <extra_id_2> banyak yang perlu di perbaiki	o
tempat enak buat persinggahan . dekat dengan bandara , bisa pesan antar .	<extra_id_0> tempat <extra_id_1> positive	as
tidak adda hanger nya sama sekali , susah untuk gantung pakaian di lemari .	<extra_id_0> hanger nya <extra_id_1> negative	as
lokasi nyaman dan tenang .	<extra_id_0> lokasi <extra_id_1> nyaman <extra_id_2> positive ; <extra_id_3> lokasi <extra_id_4> tenang <extra_id_5> positive	aos
tempat nyaman , akses gampang , petugas ramah , dapat sarapan .	<extra_id_0> tempat <extra_id_1> nyaman ; <extra_id_2> akses <extra_id_3> gampang ; <extra_id_4> petugas <extra_id_5> ramah ; <extra_id_6> sarapan <extra_id_7> dapat	ao
pelayanan bagus dapat complimentary snacks .	<extra_id_0> pelayanan ; <extra_id_1> complimentary snacks	a
masih kurang resepsionis saja yang agak lama harus menunggu lama baru datang tidak stanby dibtempat , all best lah harga murah fasilitas oke .	<extra_id_0> kurang ; <extra_id_1> agak lama ; <extra_id_2> murah ; <extra_id_3> oke	o
kamar ada semutnya . kamar mandi bermasalah . buangan air tersumbat . sehingga air meluber ke luar kamar .	<extra_id_0> kamar ; <extra_id_1> kamar mandi ; <extra_id_2> buangan air	a
resepsionis galak banget , tidak ramah sama . sekali , pintu kamar mandi tidak bisa ditutup , kamar sangat sempit tidak ada tempat untuk sembahyang .	<extra_id_0> resepsionis <extra_id_1> galak banget ; <extra_id_2> resepsionis <extra_id_3> tidak ramah ; <extra_id_4> pintu kamar mandi <extra_id_5> tidak bisa ditutup ; <extra_id_6> kamar <extra_id_7> sangat sempit	ao
ruangan nya sangat luas bisa buat satu keluarga kecil dengan 2 anak free 1 single bed , tempatnya nyaman dan bersih , kamar mandi juga luas namun akan lebih baik lagi jk dikasih pembatas antara toilet dengan shower , tapi overall sangat rekomended .	<extra_id_0> ruangan nya <extra_id_1> sangat luas ; <extra_id_2> tempatnya <extra_id_3> nyaman ; <extra_id_4> tempatnya <extra_id_5> bersih ; <extra_id_6> kamar mandi <extra_id_7> luas ; <extra_id_8> overall <extra_id_9> sangat rekomended	ao
kebersihan nya perlu di tingkat kan lagi .	<extra_id_0> kebersihan nya <extra_id_1> perlu di tingkat kan lagi <extra_id_2> negative	aos
harga ekonomis murah meriah , depan mall . dekat masjid . dekat bandara .	<extra_id_0> harga <extra_id_1> ekonomis <extra_id_2> positive ; <extra_id_3> harga <extra_id_4> murah <extra_id_5> positive	aos
fasilitas lengkap . jadi ingin inap terus ini semoga mbah google sehat selalu . jangan lupa voucher nya iya . ( 50 via app airy rooms ) pelayanan baik dan ramah . selalu respons dengan cepat disetiap ada kekurangan fasilitas , dan lainlain .	<extra_id_0> fasilitas ; <extra_id_1> pelayanan ; <extra_id_2> respons	a
nyaman dan ramah ada cemilan gratis dari airy love this .	<extra_id_0> cemilan gratis <extra_id_1> positive ; <extra_id_2> NULL <extra_id_3> positive	as
sudah 2x kesini tetapi tidak sampai mencoba breakfast nya . kalau kamar oke , bersih , nyaman . cuma kamar mandi nya kurang elit , agak sempit . hihi .	<extra_id_0> kamar <extra_id_1> positive ; <extra_id_2> kamar mandi nya <extra_id_3> negative	as
kamar bersih . tempat tidur juga nyaman . tetapi sayang di kamar saya 803 toilet sepertinya tersumbat . kamar terlalu sempit , terlalu pas pasan . sarapan juga kurang bervariasi . tetapi untuk harga discont cukup memuaskan . terimakasih .	<extra_id_0> kamar ; <extra_id_1> tempat tidur ; <extra_id_2> toilet ; <extra_id_3> sarapan ; <extra_id_4> harga	a
terima kasih sudah menampung saya selama di cengkareng . ruangan bagus , nyaman juga . sedikit koreksi , kalau boleh kamar mandi di beri exhaust .	<extra_id_0> ruangan	a
bersih , wifi kencang , cuma sempit buat sholat susah .	<extra_id_0> wifi <extra_id_1> positive ; <extra_id_2> NULL <extra_id_3> positive ; <extra_id_4> NULL <extra_id_5> negative	as
saya sangat sering menggunakan airy room , sehingga sudah tahu apa saja fasilitas yang biasanya ada . cemilan yang ada juga hanya setengah dari pada biasanya .	<extra_id_0> cemilan	a
kamar paling sempurna dari semua airy yang saya cb di jogja . kamar luas , modern , bersih banget , perfect !	<extra_id_0> paling sempurna ; <extra_id_1> luas ; <extra_id_2> modern ; <extra_id_3> bersih banget ; <extra_id_4> perfect	o
nyaman , tenang , bersih , pelayanan ramah , hanya susah sinyal dan wifi tidak bisa tersambung .	<extra_id_0> pelayanan ; <extra_id_1> wifi ; <extra_id_2> NULL	a
penginapan cukup nyaman , tetapi sayang kamar kurang terawat .	<extra_id_0> penginapan <extra_id_1> positive ; <extra_id_2> kamar <extra_id_3> negative	as
ac nya per 30 menit mati . alhasil saya tidak nyenyak tidur karena jagain ac supaya tetap on . supaya anak istri bisa tidur . kamar mandi nya agak seram . begitu saja ! think again lah !	<extra_id_0> ac nya <extra_id_1> negative ; <extra_id_2> kamar mandi nya <extra_id_3> negative	as
oke . tetapi maaf , ada nyamuknya , kamar mandi agak bau dan tidak ada sejadah .	<extra_id_0> agak bau ; <extra_id_1> tidak ada ; <extra_id_2> oke ; <extra_id_3> ada nyamuknya	o
ac kurang dingin . yang lainnya sudah oke .	<extra_id_0> ac <extra_id_1> kurang dingin <extra_id_2> negative ; <extra_id_3> yang lainnya <extra_id_4> oke <extra_id_5> positive	aos
terlalu sempit kamarnya , tetapi lumayanlah dengan budget yang segitu , pelayanan hotel juga lumayan bagus dan ramah , airy memang joss .	<extra_id_0> kamarnya <extra_id_1> terlalu sempit <extra_id_2> negative ; <extra_id_3> kamarnya <extra_id_4> lumayanlah <extra_id_5> neutral ; <extra_id_6> pelayanan hotel <extra_id_7> lumayan bagus <extra_id_8> positive ; <extra_id_9> pelayanan hotel <extra_id_10> ramah <extra_id_11> positive	aos
secara keseluruhan bagus , tetapi kamar mandi kotor lalu keran berkerak agak bocor di atap kamar mandi . kasur nyaman dan okelah untuk beristirahat .	<extra_id_0> keseluruhan <extra_id_1> positive ; <extra_id_2> kamar mandi <extra_id_3> negative ; <extra_id_4> keran <extra_id_5> negative ; <extra_id_6> atap kamar mandi <extra_id_7> negative ; <extra_id_8> kasur <extra_id_9> positive	as
pelayanan dan segalanya baik .	<extra_id_0> pelayanan ; <extra_id_1> segalanya	a
kamar jorok , berdebu , banyak sarang labalaba disetiap penjuru dinding .	<extra_id_0> kamar <extra_id_1> jorok <extra_id_2> negative ; <extra_id_3> kamar <extra_id_4> berdebu <extra_id_5> negative ; <extra_id_6> kamar <extra_id_7> banyak sarang labalaba <extra_id_8> negative	aos
kamar baik , cuma draine untuk bagian shower menyatu dengan toilet . jadi kelar mandi kamar mandi all basah .	<extra_id_0> kamar <extra_id_1> baik <extra_id_2> positive ; <extra_id_3> kamar mandi <extra_id_4> basah <extra_id_5> negative	aos
lumayan lah untuk bermalam disini .	<extra_id_0> lumayan	o
pada saat mau check out pelayanan nya tidak ada terpaksa menunggu lama mau check out .	<extra_id_0> check out <extra_id_1> negative	as
( + ) kamar cukup luas , staf ramah , sarapan enak meski hanya 1 macam ( - ) air kamar mandi yang baunya tidak enak .	<extra_id_0> kamar <extra_id_1> positive ; <extra_id_2> staf <extra_id_3> positive ; <extra_id_4> sarapan <extra_id_5> positive ; <extra_id_6> air kamar mandi <extra_id_7> negative	as
tempat bersih . pelayanan oke dan memuaskan . next trip mau menginap lagi di hotel ini .	<extra_id_0> tempat ; <extra_id_1> pelayanan	a
nyaman , bersih , dan pelayananya sangat ramah , terimakasih .	<extra_id_0> pelayananya ; <extra_id_1> NULL	a
kamar nya lumayan bagus , tetapi banyak nyamuk , pintu kamar toilet nya tidak bisa di kunci .	<extra_id_0> kamar nya <extra_id_1> lumayan bagus ; <extra_id_2> kamar nya <extra_id_3> banyak nyamuk ; <extra_id_4> pintu kamar toilet nya <extra_id_5> tidak bisa di kunci	ao
terbaik ruangan , fasilitas dan servis nya buat tidak ingin check out .	<extra_id_0> ruangan <extra_id_1> terbaik ; <extra_id_2> fasilitas <extra_id_3> terbaik ; <extra_id_4> servis nya <extra_id_5> terbaik	ao
sayang , breakfastnya sudah ditiadakan oleh airy .	<extra_id_0> breakfastnya <extra_id_1> negative	as
airy oke punya .	<extra_id_0> airy <extra_id_1> oke	ao
air panasnya tidak berfungsi .	<extra_id_0> air panasnya <extra_id_1> tidak berfungsi	ao
pelayanan ramah , kamar nyaman dan bersih .	<extra_id_0> ramah ; <extra_id_1> nyaman ; <extra_id_2> bersih	o
nyaman , tetapi kamar agak sempit dan bernyamuk .	<extra_id_0> agak sempit ; <extra_id_1> bernyamuk ; <extra_id_2> nyaman	o
air panas kurang berfungsi dan handuk lembab .	<extra_id_0> kurang berfungsi ; <extra_id_1> lembab	o
kamar besar cuma minusnya ac kurang dingin dan layanan tv nya kurang bagus .	<extra_id_0> kamar <extra_id_1> besar ; <extra_id_2> ac <extra_id_3> kurang dingin ; <extra_id_4> layanan tv nya <extra_id_5> kurang bagus	ao
air hangat kadang mati .	<extra_id_0> air hangat <extra_id_1> kadang mati <extra_id_2> negative	aos
parah kamarnya . ac bocor . water heater tidak berfungsi . air kotor . kamar mandi kotor kamar bau . seprai ada bercakbercak sperma .	<extra_id_0> parah ; <extra_id_1> bocor ; <extra_id_2> tidak berfungsi ; <extra_id_3> kotor ; <extra_id_4> bau ; <extra_id_5> ada bercakbercak sperma	o
resepsionis yang baru sangat ramah buat nyaman .	<extra_id_0> resepsionis	a
waw kamarnya luar biasa . bagus banget . bisa lihat pemandangan kota jogja .	<extra_id_0> kamarnya <extra_id_1> luar biasa <extra_id_2> positive ; <extra_id_3> kamarnya <extra_id_4> bagus banget <extra_id_5> positive	aos
tempat bersih , nyaman , pelayanan ramah , toopp banget !	<extra_id_0> bersih ; <extra_id_1> nyaman ; <extra_id_2> ramah ; <extra_id_3> toopp banget	o
nyaman tempatnya dan bersih serta pelayanannya bagus dan memuaskan .	<extra_id_0> tempatnya <extra_id_1> nyaman ; <extra_id_2> tempatnya <extra_id_3> bersih ; <extra_id_4> pelayanannya <extra_id_5> bagus ; <extra_id_6> pelayanannya <extra_id_7> memuaskan	ao
saya senang sama rooms nya .	<extra_id_0> senang	o
pelayanan cukup baik , tempat kurang strategis .	<extra_id_0> pelayanan <extra_id_1> positive ; <extra_id_2> tempat <extra_id_3> negative	as
keren . nyaman semuanya .	<extra_id_0> semuanya ; <extra_id_1> NULL	a
biasa saja . sewa 4 kamar ada saja kekurangannya .	<extra_id_0> NULL <extra_id_1> biasa saja ; <extra_id_2> kamar <extra_id_3> ada saja kekurangannya	ao
desain minimalis .	<extra_id_0> desain	a
kamar mandi terkesan kotor , kondisi kamar sudah tua , sarapan kurang variasi , air panas tidak ada , kloset kotor .	<extra_id_0> kamar mandi <extra_id_1> kotor ; <extra_id_2> sarapan <extra_id_3> kurang variasi ; <extra_id_4> air panas <extra_id_5> tidak ada ; <extra_id_6> kloset <extra_id_7> kotor	ao
lokasi sangat dekat dengan bandara , cari makan gampang dan dekat . akses gampang .	<extra_id_0> akses <extra_id_1> gampang	ao
lingkungan sepi , fasilitas bagus .	<extra_id_0> lingkungan ; <extra_id_1> fasilitas	a
pelayanan baik selama 24jam .	<extra_id_0> baik	o
nyaman bersih dan luar biasa . pelayanan lebih dari hotel .	<extra_id_0> NULL	a
pintu geser kurang rapat .	<extra_id_0> pintu geser	a
mirip kost an . mmg masih baru sih . overall , semua bagus . cuma miris buanget pas masuk kamar . hp saya langsung no signal . di kota besar yang sudah 4g tetapi signal 2g juga tidak ada . masa kita tidak bisa komunikasian sama keluarga . kalau mau telepon harus lari ke teras untuk dapatkan signal .	<extra_id_0> overall <extra_id_1> positive	as
air wc sendat . air sedikit handuk tidak standar hotel .	<extra_id_0> sendat ; <extra_id_1> sedikit ; <extra_id_2> tidak standar	o
wifi tidak ada dan pintu kamar mandi tidak bisa terkunci .	<extra_id_0> wifi <extra_id_1> tidak ada ; <extra_id_2> pintu kamar mandi <extra_id_3> tidak bisa terkunci	ao
bersih dan pelayanan yang ramah . terimakasih .	<extra_id_0> pelayanan ; <extra_id_1> NULL	a
selimut dan bantal bau seperti belum dicuci , masih ada rambut bertebaran di bantal .	<extra_id_0> selimut ; <extra_id_1> bantal	a
bagus kamae besar hanya kurang bersih .	<extra_id_0> kamae <extra_id_1> positive ; <extra_id_2> kamae <extra_id_3> negative ; <extra_id_4> NULL <extra_id_5> positive	as
suasana cukup nyaman dan tenang selama menginap .	<extra_id_0> suasana <extra_id_1> cukup nyaman ; <extra_id_2> suasana <extra_id_3> tenang	ao
awal sudah senang karena dikasih welcome cokelat , tetapi kecewa berlipat lipat karena kamar tidak sesuai di foto dan ulasan pada traveloka , kamarnya bau , banyak semut di tempat tidur , ac tidak nyala panas banget , menang di tv saja yang besar , kamar mandi tidak sempat saya pakai karena saya sekarang siap siap mau check out pindah hotel saja , nyesal sudah bayar buat 3 malam dan tidak bisa direfund .	<extra_id_0> kamar <extra_id_1> negative ; <extra_id_2> kamarnya <extra_id_3> negative ; <extra_id_4> tempat tidur <extra_id_5> negative ; <extra_id_6> ac <extra_id_7> negative ; <extra_id_8> NULL <extra_id_9> negative	as
lokasi hotelnya strategis banget . dekat kemanakemana . apalagi dekat dengan mall istana plaza . dekat pula dengan beragam tempat wisata di pusat kota . kamarnya meski kecil tetapi cukup nyaman . cuma saran saya , untuk di kamar mandi tolong ditambahi dengan tempat sampah . dan memang tidak dikasih sikat sama odol iya ? terus untuk seprai dan sarung bantal guling supaya lebih bersih lagi karena masih ada bekas bercakbercak . setidaknya dibersihkan dnegan pemutih pasti hilang deh . kan seprainya warna putih . tetapi sejauh ini nyamannyaman saja .	<extra_id_0> lokasi hotelnya <extra_id_1> strategis banget <extra_id_2> positive ; <extra_id_3> kamarnya <extra_id_4> kecil <extra_id_5> negative ; <extra_id_6> kamarnya <extra_id_7> cukup nyaman <extra_id_8> positive ; <extra_id_9> seprai <extra_id_10> ada bekas bercakbercak <extra_id_11> negative ; <extra_id_12> sarung bantal guling <extra_id_13> ada bekas bercakbercak <extra_id_14> negative ; <extra_id_15> NULL <extra_id_16> nyamannyaman <extra_id_17> positive	aos
nyaman dan menyenangkan , .	<extra_id_0> NULL	a
kamar bau shower rusak wastafel rusak pengap kotor .	<extra_id_0> kamar <extra_id_1> negative ; <extra_id_2> shower <extra_id_3> negative ; <extra_id_4> wastafel <extra_id_5> negative	as
plusnya , proses check in sangat cepat , pegawai ramah dan tanggap , breakfastnya enak . minusnya , kamar mandi agak kecil , free snacknya tidak tersedia , remote acnya suka mati .	<extra_id_0> proses check in <extra_id_1> positive ; <extra_id_2> pegawai <extra_id_3> positive ; <extra_id_4> breakfastnya <extra_id_5> positive ; <extra_id_6> kamar mandi <extra_id_7> negative ; <extra_id_8> snacknya <extra_id_9> negative ; <extra_id_10> remote acnya <extra_id_11> negative	as
pelayanan lumayan baik . ruangan dan kamar mandinya pengap . wc agak tersumbat .	<extra_id_0> pelayanan <extra_id_1> positive ; <extra_id_2> ruangan <extra_id_3> negative ; <extra_id_4> kamar mandinya <extra_id_5> negative ; <extra_id_6> wc <extra_id_7> negative	as
nyaman dan memuaskan .	<extra_id_0> NULL <extra_id_1> nyaman <extra_id_2> positive ; <extra_id_3> NULL <extra_id_4> memuaskan <extra_id_5> positive	aos
bagus room , cuma karena dekat tol agak berisik saja .	<extra_id_0> room <extra_id_1> bagus ; <extra_id_2> room <extra_id_3> agak berisik	ao
sarapannya biasa saja , kebersihan kurang .	<extra_id_0> sarapannya <extra_id_1> neutral ; <extra_id_2> kebersihan <extra_id_3> negative	as
tidak ada wifi sesuai yang di iklankan .	<extra_id_0> wifi <extra_id_1> tidak ada	ao
kamar nyaman , lumayan lah . reccomended .	<extra_id_0> nyaman ; <extra_id_1> lumayan ; <extra_id_2> reccomended	o
kotor berdebu . saya tidak berhenti bersin ketika awal masuk kamar . kesan kamarnya kumuh . wifi rusak . saya langsung check out .	<extra_id_0> kamarnya <extra_id_1> kotor berdebu ; <extra_id_2> kamarnya <extra_id_3> kumuh ; <extra_id_4> wifi <extra_id_5> rusak	ao
hotel sangat nyaman tetapi sayangnya handuk kurang bagus dan tidak ada air panas padahal seharusnya ada , overall good lah .	<extra_id_0> hotel ; <extra_id_1> handuk ; <extra_id_2> air panas ; <extra_id_3> overall	a
alhamdulillah . baik dan pas buat keluarga kecil .	<extra_id_0> NULL <extra_id_1> baik	ao
sangat nyaman inap disini , kamar meskipun kecil , tetapi tempat tidur sangat nyaman , ada tv , ac dingin banget , wifi juga kencang banget .	<extra_id_0> kamar <extra_id_1> kecil ; <extra_id_2> tempat tidur <extra_id_3> sangat nyaman ; <extra_id_4> tv <extra_id_5> ada ; <extra_id_6> ac <extra_id_7> dingin banget ; <extra_id_8> NULL <extra_id_9> sangat nyaman ; <extra_id_10> wifi <extra_id_11> kencang banget	ao
kamarnya bersih . pelayanan ramah . dekat kalau mau keliling kota bandung .	<extra_id_0> kamarnya <extra_id_1> bersih ; <extra_id_2> pelayanan <extra_id_3> ramah	ao
nyaman , bersih , pelayanan terbaik .	<extra_id_0> pelayanan <extra_id_1> terbaik ; <extra_id_2> NULL <extra_id_3> nyaman ; <extra_id_4> NULL <extra_id_5> bersih	ao
pelayanan ramah , kamar cukup bersih , tempat sangat strategic , dekat dengan semua tempat wisata kota .	<extra_id_0> pelayanan <extra_id_1> ramah <extra_id_2> positive ; <extra_id_3> kamar <extra_id_4> cukup bersih <extra_id_5> positive ; <extra_id_6> tempat <extra_id_7> sangat strategic <extra_id_8> positive	aos
masih kurang resepsionis saja yang agak lama harus menunggu lama baru datang tidak stanby dibtempat , all best lah harga murah fasilitas oke .	<extra_id_0> resepsionis <extra_id_1> kurang <extra_id_2> negative ; <extra_id_3> resepsionis <extra_id_4> agak lama <extra_id_5> negative ; <extra_id_6> harga <extra_id_7> murah <extra_id_8> positive ; <extra_id_9> fasilitas <extra_id_10> oke <extra_id_11> positive	aos
nyaman banget , airy mantap pkonya .	<extra_id_0> NULL	a
kamar bau shower rusak wastafel rusak pengap kotor .	<extra_id_0> bau ; <extra_id_1> rusak ; <extra_id_2> pengap ; <extra_id_3> kotor	o
tempatnya nyaman dan bersih ditambah suasanya menyenangkan . recomandat lah . terimakasih .	<extra_id_0> tempatnya ; <extra_id_1> suasanya ; <extra_id_2> NULL	a
waktu menginap disana listrik hotel mati sampai subuh tidak menyala , tidak ada kejelasan dan kompesasi dari pihak hotel sampai saya dan beberapa orang terus nge push dan baru diberikan kompensasi menginap di htl lain pada jam 4 pagi . tolong diperbaiki sistem dan management hotel , sop dan customer care dari airy rooms . terutama dalam hal pelayannya . terimakasih .	<extra_id_0> sistem dan management hotel	a
kamar sesuai harga . pelayanan staf sangat baik . ada air panas . tetapi sepray kuning semua . handuknya coklat bau belum kering . tidak ada lift tetapi saya betah disana .	<extra_id_0> kamar ; <extra_id_1> pelayanan staf ; <extra_id_2> air panas ; <extra_id_3> sepray ; <extra_id_4> handuknya ; <extra_id_5> lift	a
cuma kamar mandi agak menggenang airnya setelah dipakai .	<extra_id_0> kamar mandi <extra_id_1> agak menggenang <extra_id_2> negative	aos
kamar sangat nyaman penjaganya sangat ramah baik pelayanannya hebat .	<extra_id_0> kamar <extra_id_1> sangat nyaman <extra_id_2> positive ; <extra_id_3> penjaganya <extra_id_4> sangat ramah <extra_id_5> positive ; <extra_id_6> penjaganya <extra_id_7> baik <extra_id_8> positive ; <extra_id_9> pelayanannya <extra_id_10> hebat <extra_id_11> positive	aos
bersih rapi dan tidak ribet kemana mana dekat .	<extra_id_0> NULL <extra_id_1> bersih <extra_id_2> positive ; <extra_id_3> NULL <extra_id_4> rapi <extra_id_5> positive ; <extra_id_6> NULL <extra_id_7> tidak ribet <extra_id_8> positive	aos
fasilitas sesuai . bersih sangat nyaman . cuma makanan sarapannya kurang enak .	<extra_id_0> fasilitas <extra_id_1> sesuai <extra_id_2> positive ; <extra_id_3> fasilitas <extra_id_4> bersih <extra_id_5> positive ; <extra_id_6> fasilitas <extra_id_7> sangat nyaman <extra_id_8> positive ; <extra_id_9> makanan sarapannya <extra_id_10> kurang enak <extra_id_11> negative	aos
ac nya per 30 menit mati . alhasil saya tidak nyenyak tidur karena jagain ac supaya tetap on . supaya anak istri bisa tidur . kamar mandi nya agak seram . begitu saja ! think again lah !	<extra_id_0> ac nya ; <extra_id_1> kamar mandi nya	a
lokasi sangat nyaman . kamar bersih dan nyaman . tidak kalah sama fasilitas hotel .	<extra_id_0> lokasi <extra_id_1> sangat nyaman ; <extra_id_2> kamar <extra_id_3> bersih ; <extra_id_4> kamar <extra_id_5> nyaman	ao
kami puas dengan kamar dan pelayanan x , kalau ada kesempatan berlibur lagi kami pasti akan menginap di sini lagi .	<extra_id_0> kamar <extra_id_1> positive ; <extra_id_2> pelayanan <extra_id_3> positive	as
waktu menginap tidak dapat handuknya .	<extra_id_0> handuknya	a
fasilitas lengkap . dapat snack juga dari airy . terimakasih airy .	<extra_id_0> fasilitas <extra_id_1> lengkap <extra_id_2> positive ; <extra_id_3> snack <extra_id_4> dapat <extra_id_5> positive	aos
baik : keramahan pelayanan , desain bangunan yang nyaman lemah : kebersihan kamar . lantai terasa lengket . ac lambat mencapai suhu yang diinginkan .	<extra_id_0> keramahan pelayanan <extra_id_1> baik ; <extra_id_2> desain bangunan <extra_id_3> baik ; <extra_id_4> desain bangunan <extra_id_5> nyaman ; <extra_id_6> kebersihan kamar <extra_id_7> lemah ; <extra_id_8> lantai <extra_id_9> lemah ; <extra_id_10> lantai <extra_id_11> lengket ; <extra_id_12> ac <extra_id_13> lambat	ao
menu breakfastnya tidak banyak , tetapi enak .	<extra_id_0> tidak banyak ; <extra_id_1> enak	o
lumayan untuk istirahat .	<extra_id_0> NULL	a
lagi siap pulang sudah di ketokketok sama masnya yang nanyanya kurang ramah . dan handuk cuma di kasih satu , pintu kamar mandi tidak bisa ke tutup .	<extra_id_0> masnya <extra_id_1> kurang ramah <extra_id_2> negative ; <extra_id_3> handuk <extra_id_4> cuma di kasih satu <extra_id_5> negative ; <extra_id_6> pintu kamar mandi <extra_id_7> tidak bisa ke tutup <extra_id_8> negative	aos
bantalnya enak . kamarnya dingin . keset tidak ada lagi nha .	<extra_id_0> bantalnya <extra_id_1> enak <extra_id_2> positive ; <extra_id_3> kamarnya <extra_id_4> dingin <extra_id_5> positive ; <extra_id_6> keset <extra_id_7> tidak ada <extra_id_8> negative	aos
tempatnya bersih , kemarin saya tinggal 3 hari tetapi sayang airnya mati pas kemarin di pakai , iya meskipun hidup lagi menunggu 10 menit , lumayan bagus .	<extra_id_0> tempatnya <extra_id_1> bersih ; <extra_id_2> airnya <extra_id_3> mati ; <extra_id_4> NULL <extra_id_5> lumayan bagus	ao
untuk kamar standar dari segi kebersihan perlu ditingkatkan , mungkin karena bangunan dan interior lama jadi kesannya kurang nyaman , pelayanan cukup baik , ada snack juga , over all bagus .	<extra_id_0> kamar ; <extra_id_1> kebersihan ; <extra_id_2> pelayanan ; <extra_id_3> snack ; <extra_id_4> over all ; <extra_id_5> kesannya	a
bisa masuk 3 mobil ( kalau tanpa motor ) , kamar minimalis , nyaman , keren , ac dingin , pelayanan juga ramah , selalu ada yang menjaga .	<extra_id_0> kamar <extra_id_1> minimalis ; <extra_id_2> kamar <extra_id_3> nyaman ; <extra_id_4> kamar <extra_id_5> keren ; <extra_id_6> ac <extra_id_7> dingin ; <extra_id_8> pelayanan <extra_id_9> ramah	ao
bagus , rapi , pelayanan baik , tetapi airnya sangat buruk , rasa air laut .	<extra_id_0> pelayanan ; <extra_id_1> airnya ; <extra_id_2> NULL	a
pelayanan staf baik , kamarnya bersih tetapi kecil , kamar mandi bersih . secara keseluruhan cukup baik .	<extra_id_0> pelayanan staf <extra_id_1> baik <extra_id_2> positive ; <extra_id_3> kamarnya <extra_id_4> bersih <extra_id_5> positive ; <extra_id_6> kamarnya <extra_id_7> kecil <extra_id_8> negative ; <extra_id_9> kamar mandi <extra_id_10> bersih <extra_id_11> positive ; <extra_id_12> secara keseluruhan <extra_id_13> cukup baik <extra_id_14> positive	aos
kamarnya bagus , wifi lumayan kencang , tetapi lokasinya agak susah ditemukan karena masuk ke gang yang a .	<extra_id_0> kamarnya <extra_id_1> bagus ; <extra_id_2> wifi <extra_id_3> lumayan kencang ; <extra_id_4> lokasinya <extra_id_5> agak susah ditemukan	ao
tempatnya nyaman . pelayanan nya baik . pkoknya nyaman deh bisa menginap disini .	<extra_id_0> tempatnya <extra_id_1> positive ; <extra_id_2> pelayanan nya <extra_id_3> positive ; <extra_id_4> NULL <extra_id_5> positive	as
ekspresi pertama masuk kamar . seperti tidak pernah ditempat . furniturenya tua , tv tabung warna berubah - ubah . pelayanan ramah , tetapi seprai 3 hari menginap tidak diganti . wifi kencang . malam banyak binatang , susah tidur karena gatal .	<extra_id_0> furniturenya <extra_id_1> tua <extra_id_2> negative ; <extra_id_3> pelayanan <extra_id_4> ramah <extra_id_5> positive ; <extra_id_6> seprai <extra_id_7> tidak diganti <extra_id_8> negative ; <extra_id_9> wifi <extra_id_10> kencang <extra_id_11> positive	aos
lumayan tetapi bantal airy nya sedikit kotor .	<extra_id_0> bantal airy nya <extra_id_1> sedikit kotor ; <extra_id_2> NULL <extra_id_3> lumayan	ao
hotel nya bersih dan memuaskan .	<extra_id_0> hotel nya <extra_id_1> positive	as
cukup bersih . kondisi keran kamar mandi saya yang harus diperbaiki . susah bukanya .	<extra_id_0> keran kamar mandi ; <extra_id_1> NULL	a
sangat memuaskan . seprai dan handuknya wangi , kamarnya cukup bersih dan nyaman . ac dan air panasnya berfungsi dengan baik . saluran tv sedikit bermasalah tetapi cukup memuaskan . ini pengalaman kedua saya di airy gunung sahari . terima . kasih .	<extra_id_0> wangi ; <extra_id_1> cukup bersih ; <extra_id_2> nyaman ; <extra_id_3> berfungsi dengan baik ; <extra_id_4> sedikit bermasalah ; <extra_id_5> cukup memuaskan ; <extra_id_6> sangat memuaskan	o
lokasi bagus , .	<extra_id_0> lokasi <extra_id_1> bagus	ao
bersih strategis dan ekonomis .	<extra_id_0> NULL <extra_id_1> bersih ; <extra_id_2> NULL <extra_id_3> strategis ; <extra_id_4> NULL <extra_id_5> ekonomis	ao
bagus , bersih fasilitas lengkap , recoment .	<extra_id_0> fasilitas <extra_id_1> positive ; <extra_id_2> NULL <extra_id_3> positive	as
kamarnya cukup bersih dan leluasa . snack disediakan . dekat terminal transjakarta dan fasilitas umum di jalan raya .	<extra_id_0> kamarnya <extra_id_1> cukup bersih <extra_id_2> positive ; <extra_id_3> kamarnya <extra_id_4> leluasa <extra_id_5> positive ; <extra_id_6> snack <extra_id_7> disediakan <extra_id_8> positive	aos
banyak furniture tidak jauh dari pusat kota , lobi bawah banyak kuliner , lengkap walau tidak ada air panas untuk shower nya tetapi overall oke lah dengan harga segitu ) .	<extra_id_0> air panas <extra_id_1> negative ; <extra_id_2> overall <extra_id_3> positive ; <extra_id_4> NULL <extra_id_5> positive	as
tempat nyaman dan harga terjangkau .	<extra_id_0> tempat <extra_id_1> nyaman ; <extra_id_2> harga <extra_id_3> terjangkau	ao
cukup nyaman . sayangnya shower tidak mengalir dengan lancar , terpaksa mandi menggunakan keran air .	<extra_id_0> shower <extra_id_1> negative ; <extra_id_2> NULL <extra_id_3> positive	as
bagus dan bersih masukan untuk air sangat kecil .	<extra_id_0> air <extra_id_1> sangat kecil ; <extra_id_2> NULL <extra_id_3> bagus ; <extra_id_4> NULL <extra_id_5> bersih	ao
sarapan rasa standar .	<extra_id_0> sarapan	a
dapat sarapan simple . highly recommended .	<extra_id_0> sarapan <extra_id_1> dapat ; <extra_id_2> sarapan <extra_id_3> simple ; <extra_id_4> NULL <extra_id_5> highly recommended	ao
kamar luas , handuk tidak diganti hanya dirapikan , pelayanan ramah sekali .	<extra_id_0> kamar <extra_id_1> luas ; <extra_id_2> handuk <extra_id_3> tidak diganti ; <extra_id_4> pelayanan <extra_id_5> ramah sekali	ao
untuk resepsionis perlu di perbaiki supaya lebih ramah dan sopan terimakasih .	<extra_id_0> perlu di perbaiki	o
over all nyaman .	<extra_id_0> over all <extra_id_1> positive	as
kumuh dan kotor , kurang terawat .	<extra_id_0> NULL <extra_id_1> kumuh ; <extra_id_2> NULL <extra_id_3> kotor ; <extra_id_4> NULL <extra_id_5> kurang terawat	ao
kalau boleh saya putar ulang waktu saya tidak akan menginap disini .	<extra_id_0> NULL <extra_id_1> tidak akan menginap <extra_id_2> negative	aos
pintu kamar mandi rusak 206 .	<extra_id_0> pintu kamar mandi <extra_id_1> rusak <extra_id_2> negative	aos
keseluruhan good pelayanan .	<extra_id_0> keseluruhan <extra_id_1> positive	as
kebersihan kurang .	<extra_id_0> kebersihan <extra_id_1> kurang <extra_id_2> negative	aos
tidak ada wifi nya .	<extra_id_0> wifi nya <extra_id_1> tidak ada <extra_id_2> negative	aos
saya sarankan inap di raz hotel pakai airy . oke punya !	<extra_id_0> NULL	a
hotel bersih dan sesuai harga .	<extra_id_0> hotel	a
ac kurang dingin .	<extra_id_0> kurang dingin	o
lumayan lah hotel dekat ke mana mana bisa jalan kaki , dekat juga dari bandara .	<extra_id_0> NULL <extra_id_1> lumayan	ao
keseluruhan bagus , cocok untuk tempat singgah . smoking area diparkiran , yang dilantai 2 ribet turun naiknya kalau mau merokok . remote tv nya kemana iya ?	<extra_id_0> keseluruhan <extra_id_1> bagus <extra_id_2> positive	aos
bersih , rapi , pelayanan ramah . ada bonus snack lagi . he .	<extra_id_0> pelayanan ; <extra_id_1> snack ; <extra_id_2> NULL	a
kamarnya bersih , dan nyaman .	<extra_id_0> bersih ; <extra_id_1> nyaman	o
tempatnya enak , semua fasilitas ada , kamar bersih pokonya jos .	<extra_id_0> tempatnya <extra_id_1> positive ; <extra_id_2> fasilitas <extra_id_3> positive ; <extra_id_4> kamar <extra_id_5> positive ; <extra_id_6> NULL <extra_id_7> positive	as
tempat nyaman dan bersih , oke lah buat inap 1 2 malam .	<extra_id_0> tempat	a
bising , kurang bersih .	<extra_id_0> NULL <extra_id_1> bising <extra_id_2> negative ; <extra_id_3> NULL <extra_id_4> kurang bersih <extra_id_5> negative	aos
bagus , cuma untuk sarapan pagi iya disediakan juga roti selai , teh , kopi , buah sesuai dengan harga kamar biar pelanggan puas jangan cuma satu menu , harga kamar lumanyan mahal sarapan cuma naskun saja .	<extra_id_0> sarapan <extra_id_1> cuma satu menu ; <extra_id_2> harga kamar <extra_id_3> lumanyan mahal ; <extra_id_4> NULL <extra_id_5> bagus	ao
saya telepon ke no yang ada di invoice pemesanan rupanya no airy jakarta . pihak jakarta menghubungi ke buana sari 2 tetapi tidak ada yang angkat , saya dikasih no telepon airy buana sari dan berkali kali saya hubungi tidak ada juga yang angkat . dan besok pagi pun saya mau keluhan ke pihak airy roomnya tidak ada petugas yang standby .	<extra_id_0> petugas	a
airy room paling bagus yang pernah saya kunjungi .	<extra_id_0> airy room	a
tidak ada lift sehingga susah untuk orang tua karena harus naik turun tangga .	<extra_id_0> lift <extra_id_1> tidak ada <extra_id_2> negative	aos
pelayanan ramah . tetapi harga terlalu mahal untuk fasilitas seperti itu .	<extra_id_0> ramah ; <extra_id_1> terlalu mahal	o
puas sekali dengan hotel ini , saat itu 2 kamar kami di upgrade ke deluxe room .	<extra_id_0> hotel <extra_id_1> puas sekali <extra_id_2> positive	aos
tempat bersih . sangat bagus . karena semua serba baru . sayangnya parkir mobil harus di luar , tidak boleh di dalam halaman .	<extra_id_0> tempat	a
kamarnya bagus , wifi lumayan kencang , tetapi lokasinya agak susah ditemukan karena masuk ke gang yang a .	<extra_id_0> kamarnya <extra_id_1> bagus <extra_id_2> positive ; <extra_id_3> wifi <extra_id_4> lumayan kencang <extra_id_5> positive ; <extra_id_6> lokasinya <extra_id_7> agak susah ditemukan <extra_id_8> negative	aos
nyaman banget tempat dan suasananya .	<extra_id_0> tempat <extra_id_1> nyaman banget ; <extra_id_2> suasananya <extra_id_3> nyaman banget	ao
kamar bagus .	<extra_id_0> kamar <extra_id_1> positive	as
kamarnya kurang luas , selebihnya nyaman dan wifi nya lumayan buat dikamar cuma sering putusputus . dan kalau bisa sarapan nya di antar ke tiap kamar , karena kasihan buat yang terlambat akhirnya tidak kebagian sarapan . terimakasih .	<extra_id_0> kamarnya <extra_id_1> kurang luas <extra_id_2> negative ; <extra_id_3> selebihnya <extra_id_4> nyaman <extra_id_5> positive ; <extra_id_6> wifi nya <extra_id_7> lumayan <extra_id_8> positive ; <extra_id_9> wifi nya <extra_id_10> sering putusputus <extra_id_11> negative	aos
overall baik tetapi kamar agak bau dan di lemari ada kecoak mati .	<extra_id_0> overall <extra_id_1> baik ; <extra_id_2> kamar <extra_id_3> agak bau ; <extra_id_4> lemari <extra_id_5> ada kecoak mati	ao
bagus , bersih fasilitas lengkap , recoment .	<extra_id_0> fasilitas <extra_id_1> lengkap ; <extra_id_2> NULL <extra_id_3> bagus ; <extra_id_4> NULL <extra_id_5> bersih ; <extra_id_6> NULL <extra_id_7> recoment	ao
harga pas di kantong , kamar sudah memadai .	<extra_id_0> kamar	a
kamar bersih , baik , nyaman , dan sesuai dengan ekspektasi .	<extra_id_0> kamar <extra_id_1> bersih ; <extra_id_2> kamar <extra_id_3> baik ; <extra_id_4> kamar <extra_id_5> nyaman ; <extra_id_6> kamar <extra_id_7> sesuai	ao
pelayanan ramah .	<extra_id_0> pelayanan <extra_id_1> positive	as
over all enak sih , kalau buat young couple cocok .	<extra_id_0> over all <extra_id_1> positive	as
sangat rekomended sekali tempat penginapan nya .	<extra_id_0> tempat penginapan nya	a
kualitas sangat baik , kamar nyaman dan bagus , yang kurang adalah peralatan mandi tidak diberikan dan tidak ada parkir mandiri .	<extra_id_0> kualitas <extra_id_1> sangat baik ; <extra_id_2> kamar <extra_id_3> nyaman ; <extra_id_4> kamar <extra_id_5> bagus ; <extra_id_6> peralatan mandi <extra_id_7> tidak diberikan ; <extra_id_8> parkir mandiri <extra_id_9> tidak ada	ao
ac panas , banyak nyamuk , channel tv banyak yang tidak bekerja , tidak ada tisu toilet .	<extra_id_0> ac panas <extra_id_1> negative ; <extra_id_2> channel tv <extra_id_3> negative ; <extra_id_4> tisu toilet <extra_id_5> negative	as
lumayan ramah tetapi saya pul jam 1 sudah di kunci : ( .	<extra_id_0> NULL	a
( - ) kamar mandi kurang bersih berkerak . air beberapa kali mati , utamanya ketika subuh . tidak disediakan keset . air panas untuk minum siap baru jam 7 . ruangan terlalu sempit , tidak cukup space untuk sholat . sinyal hp di kamar mati suri ( + ) lokasi bagus , menyewakan motor , wifi kencang .	<extra_id_0> kamar mandi ; <extra_id_1> air ; <extra_id_2> keset ; <extra_id_3> ruangan ; <extra_id_4> lokasi ; <extra_id_5> wifi	a
oke dengan harga kamarnya .	<extra_id_0> NULL <extra_id_1> positive	as
kualitas kamar dan pelayanan baik .	<extra_id_0> kualitas kamar ; <extra_id_1> pelayanan	a
ekspresi pertama masuk kamar . seperti tidak pernah ditempat . furniturenya tua , tv tabung warna berubah - ubah . pelayanan ramah , tetapi seprai 3 hari menginap tidak diganti . wifi kencang . malam banyak binatang , susah tidur karena gatal .	<extra_id_0> tua ; <extra_id_1> ramah ; <extra_id_2> tidak diganti ; <extra_id_3> kencang	o
tempatnya sangat nyaman , enak kalau buat nyatai .	<extra_id_0> tempatnya <extra_id_1> sangat nyaman ; <extra_id_2> tempatnya <extra_id_3> enak	ao
bagus , nyaman , aman dan bersih .	<extra_id_0> bagus ; <extra_id_1> nyaman ; <extra_id_2> aman ; <extra_id_3> bersih	o
wifi tolong di perbaiki untuk kenyamanan .	<extra_id_0> wifi <extra_id_1> negative	as
tempat sangat bersih dan nyaman .	<extra_id_0> tempat <extra_id_1> sangat bersih <extra_id_2> positive ; <extra_id_3> tempat <extra_id_4> nyaman <extra_id_5> positive	aos
letak hotel strategis .	<extra_id_0> letak hotel	a
lokasi memang agak masuk ke dalam gang dan belum ada plang airy karena baru seminggu hotel ini beroperasi . tetapi kualitas dan pelayanan hotel oke banget !	<extra_id_0> kualitas <extra_id_1> oke banget <extra_id_2> positive ; <extra_id_3> pelayanan hotel <extra_id_4> oke banget <extra_id_5> positive	aos
menyenangkan inap disini , sudah beberapa x tidak kecewa , terimakasih airy ariandri .	<extra_id_0> menyenangkan ; <extra_id_1> tidak kecewa	o
kamar memang benar sih luas . tetapi untuk kamar mandi haduh bau nya tidak nguatin . entah karena salurannya atau karena apa . tetapi mmg baunya kebanget . sampai belain beli stella . karena satu kamar bau kamar mandi semua . air panas juga tidak bekerja .	<extra_id_0> kamar <extra_id_1> luas ; <extra_id_2> kamar mandi <extra_id_3> bau ; <extra_id_4> air panas <extra_id_5> tidak bekerja	ao
kamarnya tidak sebersih sesuai standar airy lantai nya kotor seperti tidak dsapu .	<extra_id_0> kamarnya ; <extra_id_1> lantai nya	a
mantap sangat .	<extra_id_0> NULL	a
good , cuma kalau naik tangga ke atas lelah juragan .	<extra_id_0> NULL <extra_id_1> positive	as
tempat bersih , fasilitas oke , pelayan oke , mengutamakan tamu yang ada . rekomeded pokoknya .	<extra_id_0> tempat <extra_id_1> positive ; <extra_id_2> fasilitas <extra_id_3> positive ; <extra_id_4> pelayan <extra_id_5> positive ; <extra_id_6> NULL <extra_id_7> positive	as
tidak ada sabun cuci piring , air di kamar mandi mengucur kecil , .	<extra_id_0> sabun cuci piring <extra_id_1> tidak ada ; <extra_id_2> air <extra_id_3> mengucur kecil	ao
lokasi stategis . harga terjangkau .	<extra_id_0> lokasi <extra_id_1> stategis ; <extra_id_2> harga <extra_id_3> terjangkau	ao
ekonomis , dekat ke plaza semanggi , dekat ke jalan tol , dekat ke pasar benhil .	<extra_id_0> NULL <extra_id_1> ekonomis <extra_id_2> positive	aos
kolam iya saja yang lumayan recomemded .	<extra_id_0> kolam <extra_id_1> lumayan recomemded <extra_id_2> positive	aos
overall saya puas menginap disini . dan jika ada kesempatan dilain waktu akan menginap lagi disini . terima kasih .	<extra_id_0> puas	o
pelayanan yang sangat mengecewakan .	<extra_id_0> sangat mengecewakan	o
bersih dan nyaman .	<extra_id_0> NULL <extra_id_1> positive	as
pertama datang saya dikasih kamar yang buat berdua padahal saya memesan kamar yang untuk berempat dan tidak ada desain nya airyroom di kamar dan tidak dapat snack kalau tidak di keluhan pokok nya kecewa menginap disini .	<extra_id_0> NULL <extra_id_1> kecewa <extra_id_2> negative	aos
oke , kamar luas nyaman . tetapi di ujung .	<extra_id_0> luas ; <extra_id_1> nyaman ; <extra_id_2> oke	o
"aku puas banget dengan hotel pakai airy di bangka . aku pikir jenis dan standar hotelnya mirip seperti begitu . ternyata beda banget dengan hotel ini . 1 . hotel ini tiga tingkat tetapi tidak ada lift 2 . tidak ada petugas buat angkat koper 3 . tidak ada restorant . intinya tmp ini tidak pantes di sebut sebagai hotel . lebih pantas kalau disebut "" kos kosan harian "" ."	<extra_id_0> lift <extra_id_1> tidak ada <extra_id_2> negative ; <extra_id_3> petugas <extra_id_4> tidak ada <extra_id_5> negative ; <extra_id_6> restorant <extra_id_7> tidak ada <extra_id_8> negative	aos
pelayanan staf baik , kamarnya bersih tetapi kecil , kamar mandi bersih . secara keseluruhan cukup baik .	<extra_id_0> pelayanan staf <extra_id_1> positive ; <extra_id_2> kamarnya <extra_id_3> positive ; <extra_id_4> kamarnya <extra_id_5> negative ; <extra_id_6> kamar mandi <extra_id_7> positive ; <extra_id_8> secara keseluruhan <extra_id_9> positive	as
acnya kurang dingin , wifi juga tidak ada : ( .	<extra_id_0> acnya <extra_id_1> kurang dingin <extra_id_2> negative ; <extra_id_3> wifi <extra_id_4> tidak ada <extra_id_5> negative	aos
kamar bersih dan rapi . pemilik ramah . terimakasih .	<extra_id_0> kamar <extra_id_1> bersih ; <extra_id_2> kamar <extra_id_3> rapi ; <extra_id_4> pemilik <extra_id_5> ramah	ao
bagus . nyaman . bersih .	<extra_id_0> NULL <extra_id_1> bagus <extra_id_2> positive ; <extra_id_3> NULL <extra_id_4> nyaman <extra_id_5> positive ; <extra_id_6> NULL <extra_id_7> bersih <extra_id_8> positive	aos
oke saja lah , wi - fi tidak ada .	<extra_id_0> wi - fi ; <extra_id_1> NULL	a
enak banget nyaman , feels like home .	<extra_id_0> NULL <extra_id_1> enak banget <extra_id_2> positive ; <extra_id_3> NULL <extra_id_4> nyaman <extra_id_5> positive	aos
kebersihan seprai dan selimut perlu lebih diperhatikan .	<extra_id_0> kebersihan seprai dan selimut	a
ac tidak dingin , sudah 3x lapor tidak ada tanggapan sama sekali , lantai keramik banyak yang rusak .	<extra_id_0> ac ; <extra_id_1> lantai	a
lumayan lah .	<extra_id_0> lumayan	o
handuk nya kurang halus .	<extra_id_0> kurang halus	o
bersih , nyaman , kamar luas , ada snack , toiletries juga oke .	<extra_id_0> luas ; <extra_id_1> ada ; <extra_id_2> oke ; <extra_id_3> bersih ; <extra_id_4> nyaman	o
keamanan hotel mengecewakan . ktp saya beserta tamu hotel lainnya hilang dicuri dikarenakan kelalaian penjagaan . ditambah cctv yang ada di hotel ternyata tidak aktif .	<extra_id_0> keamanan hotel <extra_id_1> negative	as
so far sebenarnya nyaman , pelayanan bagus , tetapi kok sarung bantal sama selimutnya seperti tidak dicuci : ( .	<extra_id_0> pelayanan <extra_id_1> bagus <extra_id_2> positive ; <extra_id_3> sarung bantal <extra_id_4> tidak dicuci <extra_id_5> negative ; <extra_id_6> selimutnya <extra_id_7> tidak dicuci <extra_id_8> negative ; <extra_id_9> NULL <extra_id_10> nyaman <extra_id_11> positive	aos
nyaman dan pelayanan sangat bagus .	<extra_id_0> sangat bagus ; <extra_id_1> nyaman	o
pelayanan baik tempat juga nyaman dan bersih .	<extra_id_0> pelayanan ; <extra_id_1> tempat	a
kamar nyaman , cari makan mudah , tetapi kok sinyal di dalam kamar agak susah .	<extra_id_0> kamar <extra_id_1> positive ; <extra_id_2> sinyal <extra_id_3> negative	as
kamarnya besar , bersihh pelayanan ramah , harga yang diberikan sangat memuaskan saat melihat kamarnya lengkap , tetapi akses ke kamarnya yang jauh dibelakang sih dan aroma nya kurang suka , over all ini keren harusnya tidak semurah itu kalau tidak pakai airy room , top deh tidak mengecewakan .	<extra_id_0> kamarnya ; <extra_id_1> pelayanan ; <extra_id_2> harga ; <extra_id_3> aroma nya ; <extra_id_4> over all	a
ac tidak dingin , airnya kecil . seharusnya sebelum ada yang booking diperiksa dulu .	<extra_id_0> ac <extra_id_1> tidak dingin ; <extra_id_2> airnya <extra_id_3> kecil	ao
kamar nya bersih dan mbakmbak nya ramah dan selalu di kasih kamar no 1 .	<extra_id_0> kamar nya <extra_id_1> positive ; <extra_id_2> mbakmbak nya <extra_id_3> positive	as
ac kurang dingin , tetapi overall puas .	<extra_id_0> ac <extra_id_1> kurang dingin <extra_id_2> negative ; <extra_id_3> overall <extra_id_4> puas <extra_id_5> positive	aos
keseluruhan cukup baik iya dengan harga promo yang sangat murah , tetapi kamarnya sempit , dan properti sudah agak usang .	<extra_id_0> keseluruhan <extra_id_1> positive ; <extra_id_2> harga promo <extra_id_3> positive ; <extra_id_4> kamarnya <extra_id_5> negative ; <extra_id_6> properti <extra_id_7> negative	as
sesuai antara harga dan fasilitasnya . kamar bersih . tetapi sayang acara tv kurang bagus sinyalnya .	<extra_id_0> harga <extra_id_1> sesuai ; <extra_id_2> fasilitasnya <extra_id_3> sesuai ; <extra_id_4> kamar <extra_id_5> bersih ; <extra_id_6> tv <extra_id_7> kurang bagus sinyalnya	ao
kamar cukup luas .	<extra_id_0> kamar <extra_id_1> positive	as
kamarnya lumayan bagus , cuma sayang air panasnya sedikit saja , jadi kurang bagus .	<extra_id_0> kamarnya <extra_id_1> lumayan bagus ; <extra_id_2> air panasnya <extra_id_3> sedikit ; <extra_id_4> NULL <extra_id_5> kurang bagus	ao
banyak nyamuk , sinyal tv jelek , tidak ada wifi . wc kotor ada tikus .	<extra_id_0> sinyal tv <extra_id_1> jelek ; <extra_id_2> wifi <extra_id_3> tidak ada ; <extra_id_4> wc <extra_id_5> kotor ; <extra_id_6> wc <extra_id_7> ada tikus ; <extra_id_8> NULL <extra_id_9> banyak nyamuk	ao
kamar panas karena ac tidak dingin .	<extra_id_0> kamar <extra_id_1> panas ; <extra_id_2> ac <extra_id_3> tidak dingin	ao
bangunan dan ruangan bagus .	<extra_id_0> bangunan ; <extra_id_1> ruangan	a
kamar nya bersih sekali , adem , nyaman pkoknya . harga sesuai banget sama kantong . very recomended .	<extra_id_0> kamar nya <extra_id_1> bersih sekali ; <extra_id_2> kamar nya <extra_id_3> adem ; <extra_id_4> kamar nya <extra_id_5> nyaman ; <extra_id_6> harga <extra_id_7> sesuai banget ; <extra_id_8> NULL <extra_id_9> very recomended	ao
lumayan bagus , resepsionis harusnya 24 jam standby .	<extra_id_0> lumayan bagus	o
hotel yang sudah agak tua , dan sedikit menyeramkan . tetapi harga sangat murah .	<extra_id_0> hotel <extra_id_1> negative ; <extra_id_2> harga <extra_id_3> positive	as
front office kurang welcome ke tamu , kebersihan kurang banget , lokasi parkir yang terlalu minim terimakasih .	<extra_id_0> front office <extra_id_1> negative ; <extra_id_2> kebersihan <extra_id_3> negative ; <extra_id_4> lokasi parkir <extra_id_5> negative	as
sangat senang dengan fasilitas kamarnya , akan lebih baik jika ada sarapan paginya .	<extra_id_0> fasilitas kamarnya <extra_id_1> sangat senang <extra_id_2> positive	aos
ketika pertama masuk kamar bau apek , untuk pengharum ruangannya tidak ada .	<extra_id_0> bau apek ; <extra_id_1> tidak ada	o
remote tv tidak ada baterai , air panas rusak , kamar kotor , tidaka ada bath math , berantakan . sudah follow up ke deva airy tidak ada respons ulang .	<extra_id_0> remote tv ; <extra_id_1> air panas ; <extra_id_2> kamar ; <extra_id_3> bath math	a
kamar sangat memuaskan . sedikit catatan sayang , lokasi penginapan ini di dalam gang . mungkin akan agak sulit ditemukan .	<extra_id_0> kamar <extra_id_1> sangat memuaskan <extra_id_2> positive	aos
lokasi cukup strategis , hanya air kamar mandi bagus .	<extra_id_0> lokasi <extra_id_1> cukup strategis <extra_id_2> positive ; <extra_id_3> air kamar mandi <extra_id_4> bagus <extra_id_5> positive	aos
pelayanannya ramah . tempat tidur nyaman , bersih , ac menyala air panas bisa di gunakan wifinya sangat kencang . mungkin yang perlu diperbaiki bau saluran air di kamar mandi , tetapi langsung hilang baunya sejauh ini sangat memuaskan . terimakasih .	<extra_id_0> pelayanannya <extra_id_1> positive ; <extra_id_2> tempat tidur <extra_id_3> positive ; <extra_id_4> ac <extra_id_5> positive ; <extra_id_6> air panas <extra_id_7> positive ; <extra_id_8> wifinya <extra_id_9> positive ; <extra_id_10> bau saluran air <extra_id_11> negative ; <extra_id_12> NULL <extra_id_13> positive	as
sesuai dengan janji , rekomended .	<extra_id_0> NULL <extra_id_1> rekomended <extra_id_2> positive	aos
kamar yang saya dapat kurang bersih .	<extra_id_0> kamar <extra_id_1> negative	as
hotel airy terbaik yang pernah saya temui .	<extra_id_0> hotel	a
airnya sempat mati . pelayanan kurang profesional .	<extra_id_0> airnya <extra_id_1> sempat mati <extra_id_2> negative ; <extra_id_3> pelayanan <extra_id_4> kurang profesional <extra_id_5> negative	aos
lumayan lah . sesuai harga . tetapi jauh tmpatnya .	<extra_id_0> NULL	a
nyaman tetapi ac bocor .	<extra_id_0> ac ; <extra_id_1> NULL	a
ac nya kurang dingin dan kotor , banyak nyamuk dan kurang terawat kamarnya . bau kamar tidak enak smp saya beli obat semprot nyamuk dan beli pengharum ruangan . kolam renang bersih .	<extra_id_0> ac nya <extra_id_1> negative ; <extra_id_2> kamarnya <extra_id_3> negative ; <extra_id_4> bau kamar <extra_id_5> negative ; <extra_id_6> kolam renang <extra_id_7> positive	as
lokasi tengah kota , kamar nyaman . enaklah pokoknya .	<extra_id_0> nyaman ; <extra_id_1> enaklah	o
lagi siap pulang sudah di ketokketok sama masnya yang nanyanya kurang ramah . dan handuk cuma di kasih satu , pintu kamar mandi tidak bisa ke tutup .	<extra_id_0> masnya <extra_id_1> kurang ramah ; <extra_id_2> handuk <extra_id_3> cuma di kasih satu ; <extra_id_4> pintu kamar mandi <extra_id_5> tidak bisa ke tutup	ao
kamar budgett sekali di jakarta .	<extra_id_0> kamar <extra_id_1> budgett sekali <extra_id_2> negative	aos
harga murah , kualitas kamar bagus , tidak nyesal inap di tempat ini .	<extra_id_0> harga <extra_id_1> murah ; <extra_id_2> kualitas kamar <extra_id_3> bagus ; <extra_id_4> inap <extra_id_5> tidak nyesal	ao
lokasi sangat strategis , parkir luas , air hangat berfungsi dengan baik . kurang bersih , selimut agak bau , dan tv kabel tidak berfungsi .	<extra_id_0> lokasi ; <extra_id_1> parkir ; <extra_id_2> air hangat ; <extra_id_3> selimut ; <extra_id_4> tv kabel ; <extra_id_5> NULL	a
untuk lokasinya , harga sangat murah .	<extra_id_0> harga <extra_id_1> sangat murah <extra_id_2> positive	aos
menyenangkan dan nyaman tetapi untuk peralatan keamanan masih manual contoh pintu pagar belum di lengkapi dengan peralatan seperti pintu otomatis dengan menggunakan pin .	<extra_id_0> peralatan keamanan <extra_id_1> manual ; <extra_id_2> NULL <extra_id_3> menyenangkan ; <extra_id_4> NULL <extra_id_5> nyaman	ao
sangat memuaskan . seprai dan handuknya wangi , kamarnya cukup bersih dan nyaman . ac dan air panasnya berfungsi dengan baik . saluran tv sedikit bermasalah tetapi cukup memuaskan . ini pengalaman kedua saya di airy gunung sahari . terima . kasih .	<extra_id_0> seprai <extra_id_1> wangi ; <extra_id_2> handuknya <extra_id_3> wangi ; <extra_id_4> kamarnya <extra_id_5> cukup bersih ; <extra_id_6> kamarnya <extra_id_7> nyaman ; <extra_id_8> ac <extra_id_9> berfungsi dengan baik ; <extra_id_10> air panasnya <extra_id_11> berfungsi dengan baik ; <extra_id_12> saluran tv <extra_id_13> sedikit bermasalah ; <extra_id_14> saluran tv <extra_id_15> cukup memuaskan ; <extra_id_16> NULL <extra_id_17> sangat memuaskan	ao
kamar kecil banget sempit dan kamar mandinya bocor sampai banjir ke kolong kasur .	<extra_id_0> kecil banget ; <extra_id_1> sempit ; <extra_id_2> bocor	o
room minimalis , cukup luas untuk harga begini . staf ramah banget dari satuan pengamanan sampai front desk .	<extra_id_0> room ; <extra_id_1> staf	a
maaf saya mau berkomentar kamar yang saya pesan tidak sesuai dengan yang di foto pelayanan nya kurang baik pintu rusak jendela terbuka mohon untuk di perbaharui agar kami saja yang terakhir kalinya menggunakan kamar tersebut sebelum di renovasi terimakasih .	<extra_id_0> kurang baik ; <extra_id_1> rusak	o
nyaman , bersih , dan murah .	<extra_id_0> NULL	a
desain ruang lobi terlalu dalam , kalau bisa sekat dindingnya dibuka sehingga bisa kelihatan pemandangan diluar .	<extra_id_0> desain ruang lobi <extra_id_1> terlalu dalam <extra_id_2> negative	aos
ac tidak dingin , kamar mandinya kurang bersih .	<extra_id_0> ac <extra_id_1> negative ; <extra_id_2> kamar mandinya <extra_id_3> negative	as
kamarnya kurang bersih , seprai kotor , handuk sudah tidak layak pakai .	<extra_id_0> kurang bersih ; <extra_id_1> kotor ; <extra_id_2> tidak layak pakai	o
sangat puas dengan tempat dan pelayanannya .	<extra_id_0> tempat <extra_id_1> sangat puas <extra_id_2> positive ; <extra_id_3> pelayanannya <extra_id_4> sangat puas <extra_id_5> positive	aos
tempat yag bagus dan nyaman untuk istirahat tetapi tolong tvnya perlu di perbaiki channelnya karena banyak semutnya digambar dan water heaternya tidak bisa jadi mandi air dingin terus .	<extra_id_0> bagus ; <extra_id_1> nyaman ; <extra_id_2> perlu di perbaiki ; <extra_id_3> tidak bisa	o
tempat bersih , nyaman , pelayanan ramah , toopp banget !	<extra_id_0> tempat <extra_id_1> bersih <extra_id_2> positive ; <extra_id_3> tempat <extra_id_4> nyaman <extra_id_5> positive ; <extra_id_6> pelayanan <extra_id_7> ramah <extra_id_8> positive ; <extra_id_9> pelayanan <extra_id_10> toopp banget <extra_id_11> positive	aos
harga murah . banyak tempat wisata malam di sekitaran nya .	<extra_id_0> harga	a
bagus . pelayanannya baik .	<extra_id_0> pelayanannya <extra_id_1> positive ; <extra_id_2> NULL <extra_id_3> positive	as
airnya jam 12 malam mati , padahal sangat butuh .	<extra_id_0> airnya <extra_id_1> mati <extra_id_2> negative	aos
pemandangan indah , kebersihan lumayan , hanya saja bangunan dan interior lama sudah banyak yang retak , rusak , pintu kamar mandi susah ditutup , pintu kamar berderit . sarapan standar sekali , kurang variasi .	<extra_id_0> indah ; <extra_id_1> lumayan ; <extra_id_2> susah ditutup ; <extra_id_3> berderit ; <extra_id_4> standar sekali ; <extra_id_5> kurang variasi	o
dengan harga terjangkau bisa dibilang memuaskan . kamar bersih , nyaman , dan tenang . cuma di kamar yang saya pesan pintu kamar mandi rusak .	<extra_id_0> harga <extra_id_1> positive ; <extra_id_2> kamar <extra_id_3> positive ; <extra_id_4> pintu kamar mandi <extra_id_5> negative ; <extra_id_6> NULL <extra_id_7> positive	as
harga terjangkau dan dekat dengan pusat kota bandung .	<extra_id_0> harga <extra_id_1> terjangkau <extra_id_2> positive	aos
sangat nyaman . snack nya kurang banyak .	<extra_id_0> snack nya <extra_id_1> kurang banyak <extra_id_2> negative ; <extra_id_3> NULL <extra_id_4> sangat nyaman <extra_id_5> positive	aos
lumayan . cuma bantal nya kalau bisa di jemur atau di cuci . niar tidak bau keringat . terimakasih .	<extra_id_0> bantal ; <extra_id_1> NULL	a
bagus , walopun datang dini hari namun tetap dilayani dengan baik .	<extra_id_0> baik ; <extra_id_1> bagus	o
manajemennya tidak bagus karena sudah beli kamar tetapi bahkan kamar saya di jual ke pihak yang lain .	<extra_id_0> manajemennya <extra_id_1> tidak bagus	ao
lumayan untuk harga diskon . ac , tv , westafel semua baik . cuma kmrrn habis ada wedding party , belum selesai , jadi sampah nya bau .	<extra_id_0> ac <extra_id_1> positive ; <extra_id_2> tv <extra_id_3> positive ; <extra_id_4> westafel <extra_id_5> positive	as
kamar bersih tetapi kamar mandi kotor tidak terawat .	<extra_id_0> bersih ; <extra_id_1> kotor ; <extra_id_2> tidak terawat	o
aman , nyaman , strategis , dan ekonomis .	<extra_id_0> aman ; <extra_id_1> nyaman ; <extra_id_2> strategis ; <extra_id_3> ekonomis	o
bagus , cuma diberi room lantai paling atas harus turun tangga karena tidak ada lifnya .	<extra_id_0> lifnya ; <extra_id_1> NULL	a
staf ramah kamar masih kurang bersih .	<extra_id_0> staf <extra_id_1> positive ; <extra_id_2> kamar <extra_id_3> negative	as
seprai dan bed cover tidak bersih , air panas tidak menyala , wifi di kamar tidak tersedia .	<extra_id_0> tidak bersih ; <extra_id_1> tidak menyala ; <extra_id_2> tidak tersedia	o
biasa saja . sewa 4 kamar ada saja kekurangannya .	<extra_id_0> NULL <extra_id_1> neutral ; <extra_id_2> kamar <extra_id_3> negative	as
pelayanan oke , fasilitas big no , dikamar tidak ada keset , flapon seperti rembesan air begitu sudah lumutan , agak bau apek , ac kurang dingin , pembuangan air kamar mandi agak tersumbat , tidak rekomen lah pokok iya .	<extra_id_0> pelayanan <extra_id_1> positive ; <extra_id_2> fasilitas <extra_id_3> negative ; <extra_id_4> keset <extra_id_5> negative ; <extra_id_6> flapon <extra_id_7> negative ; <extra_id_8> ac <extra_id_9> negative ; <extra_id_10> pembuangan air kamar mandi <extra_id_11> negative ; <extra_id_12> NULL <extra_id_13> negative	as
kamar mandi terkesan kotor , kondisi kamar sudah tua , sarapan kurang variasi , air panas tidak ada , kloset kotor .	<extra_id_0> kamar mandi ; <extra_id_1> sarapan ; <extra_id_2> air panas ; <extra_id_3> kloset	a
saya dan kelg senang menginap , tetapi sayangnya tidak bisa memilih kamar karena kami orang tua sudah pada umur dan tidak bisa bersebelahan kamarnya , tempatnya tidak susah mencarinya , yang ptg enak deh , semoga saya dan kelg bisa pesan lagi .	<extra_id_0> tempatnya <extra_id_1> tidak susah mencarinya <extra_id_2> positive ; <extra_id_3> tempatnya <extra_id_4> enak <extra_id_5> positive	aos
sangat menyenangkan . tetapi untuk masalah privasi kurang terjaga karena jendela kaca tidak dilengkapi kain trasparan sehingga terlihat jelas dari luar .	<extra_id_0> privasi <extra_id_1> kurang terjaga <extra_id_2> negative ; <extra_id_3> NULL <extra_id_4> sangat menyenangkan <extra_id_5> positive	aos
recommended . untuk harga segitu , lumayan lah .	<extra_id_0> NULL <extra_id_1> positive	as
kurang nyaman kurang bersih kurang rapi dan kurang ramah pelayanannya sangat sangat kecewa baru kali ini inap di airy rooms kecewa sebelumnya sya selalu senang mnginap di airyromms .	<extra_id_0> kurang ramah ; <extra_id_1> kurang nyaman ; <extra_id_2> kurang bersih ; <extra_id_3> kurang rapi ; <extra_id_4> sangat sangat kecewa	o
kamar mandinya sedikit sempit dan di kamar ada nyamuk sedikitt .	<extra_id_0> sedikit sempit ; <extra_id_1> ada nyamuk sedikitt	o
kamar nyaman dan bersih . pelayanan baik .	<extra_id_0> kamar <extra_id_1> nyaman ; <extra_id_2> kamar <extra_id_3> bersih ; <extra_id_4> pelayanan <extra_id_5> baik	ao
kamar nyaman , penjaga ramah , dan sopan .	<extra_id_0> kamar <extra_id_1> nyaman <extra_id_2> positive ; <extra_id_3> penjaga <extra_id_4> ramah <extra_id_5> positive ; <extra_id_6> penjaga <extra_id_7> sopan <extra_id_8> positive	aos
ini pengalaman menginap terburuk yang pernah saya rasakan .	<extra_id_0> pengalaman <extra_id_1> terburuk	ao
kamarnya bagus , nyaman bersih , mbak nya baik ramah .	<extra_id_0> bagus ; <extra_id_1> nyaman ; <extra_id_2> bersih ; <extra_id_3> baik ; <extra_id_4> ramah	o
tempatnya bersih , dekat dengan penjual makanan jadi tinggal milih mau makan apa , pelayannya juga ramah .	<extra_id_0> tempatnya <extra_id_1> bersih ; <extra_id_2> pelayannya <extra_id_3> ramah	ao
tempatnya nyaman , resepsionis ramah . tetapi pas dikamar mandi bathtupnya tidak bisa diisi karena penutupnya rusak .	<extra_id_0> tempatnya ; <extra_id_1> resepsionis ; <extra_id_2> bathtupnya ; <extra_id_3> penutupnya	a
pelayanan si masnya sangat ramah , saya sudah berlangganan di airy eco deplu hampir setengah tahun . kamarnya rapi , fasilitas lengkap , dan its cheap !	<extra_id_0> pelayanan ; <extra_id_1> kamarnya ; <extra_id_2> fasilitas	a
air di wastafel tidak keluar .	<extra_id_0> air <extra_id_1> negative	as
kamarnya bersih , rapi , alat mandi lengkap , dan disediakan makanan ringan di dalam kamar . sarapan roti dan minuman seduh sendiri . sangat direkomendasi buat yang budget minimal . terimakasih .	<extra_id_0> kamarnya <extra_id_1> bersih <extra_id_2> positive ; <extra_id_3> kamarnya <extra_id_4> rapi <extra_id_5> positive ; <extra_id_6> alat mandi <extra_id_7> lengkap <extra_id_8> positive ; <extra_id_9> makanan ringan <extra_id_10> disediakan <extra_id_11> positive ; <extra_id_12> NULL <extra_id_13> sangat direkomendasi <extra_id_14> positive	aos
kunci pintu kamar mandinya rusak .	<extra_id_0> rusak	o
saya telepon ke no yang ada di invoice pemesanan rupanya no airy jakarta . pihak jakarta menghubungi ke buana sari 2 tetapi tidak ada yang angkat , saya dikasih no telepon airy buana sari dan berkali kali saya hubungi tidak ada juga yang angkat . dan besok pagi pun saya mau keluhan ke pihak airy roomnya tidak ada petugas yang standby .	<extra_id_0> tidak ada	o
bagus , kurangnya adalah pecahayaan ruangan kurang terang .	<extra_id_0> pecahayaan ruangan <extra_id_1> negative ; <extra_id_2> NULL <extra_id_3> positive	as
air kotor yang dari water heaternya . sudah begitu mati pas ahirahir mau dipakai . tetapi overall good sihh .	<extra_id_0> air ; <extra_id_1> overall	a
pelayanan dan segalanya baik .	<extra_id_0> pelayanan <extra_id_1> baik <extra_id_2> positive ; <extra_id_3> segalanya <extra_id_4> baik <extra_id_5> positive	aos
memuaskan . makanan enak , pelayanan bagus . thank untuk airyroom .	<extra_id_0> makanan <extra_id_1> positive ; <extra_id_2> pelayanan <extra_id_3> positive ; <extra_id_4> NULL <extra_id_5> positive	as
selalu suka dengan pelayanannya .	<extra_id_0> pelayanannya <extra_id_1> selalu suka	ao
harga sangat terjangkau dan fasilitas yang di dapat juga baik . sebanding dengan harganya . terima kasih , d'amancu !	<extra_id_0> sangat terjangkau ; <extra_id_1> baik	o
mantap hotelnya baik dengan harga airy room .	<extra_id_0> hotelnya	a
resepsionis nya ramah . semua karyawan hotel baik dan ramah .	<extra_id_0> resepsionis nya <extra_id_1> ramah <extra_id_2> positive ; <extra_id_3> karyawan hotel <extra_id_4> baik <extra_id_5> positive ; <extra_id_6> karyawan hotel <extra_id_7> ramah <extra_id_8> positive	aos
tolong agak disiplin klok tamu meminta kamarnya di bersihkan .	<extra_id_0> tolong agak disiplin	o
kamar hotel bersih , nyaman dan suasananya tenang banget . staf hotelnya pun sangat ramah dan baik .	<extra_id_0> kamar hotel <extra_id_1> positive ; <extra_id_2> suasananya <extra_id_3> positive ; <extra_id_4> staf hotelnya <extra_id_5> positive	as
pemandangan dan suasana oke tetapi tempat tidurnya tidak nyaman . bangun tidur badan pegal jadi sering kebangun . pesan 2 kamar yang satu air panas tidak berfungsi dan lampu tidur mati 1 . kolam renang kotor seperti tidak terurus . over all oke . servicenya cepat dan ramah .	<extra_id_0> pemandangan <extra_id_1> positive ; <extra_id_2> suasana <extra_id_3> positive ; <extra_id_4> tempat tidurnya <extra_id_5> negative ; <extra_id_6> air panas <extra_id_7> negative ; <extra_id_8> lampu tidur <extra_id_9> negative ; <extra_id_10> kolam renang <extra_id_11> negative ; <extra_id_12> over all <extra_id_13> positive ; <extra_id_14> servicenya <extra_id_15> positive	as
sangat puas . terbaik .	<extra_id_0> NULL <extra_id_1> positive	as
pelayanan baik . fasilitas oke .	<extra_id_0> pelayanan <extra_id_1> baik <extra_id_2> positive ; <extra_id_3> fasilitas <extra_id_4> oke <extra_id_5> positive	aos
resepsionis ramah dan informatif .	<extra_id_0> resepsionis	a
hotel yang bersahabat dengan nyamuk , makanan selalu habis .	<extra_id_0> selalu habis	o
karyawan kurang ramah dan kurang baik .	<extra_id_0> kurang ramah ; <extra_id_1> kurang baik	o
kamar kotor .	<extra_id_0> kamar	a
check in mudah . kamar bersih . hadiah kelengkapan airy komplit .	<extra_id_0> mudah ; <extra_id_1> bersih ; <extra_id_2> komplit	o
bersih , rapi dan nyaman . tetapi wifi ter suspended .	<extra_id_0> wifi <extra_id_1> ter suspended ; <extra_id_2> NULL <extra_id_3> bersih ; <extra_id_4> NULL <extra_id_5> rapi ; <extra_id_6> NULL <extra_id_7> nyaman	ao
cara pemesanan mudah , harga cukup ramah di kantong , kamar bersih , pelayanan bagus , recommended , tempatnya juga di tengah kota .	<extra_id_0> cara pemesanan ; <extra_id_1> harga ; <extra_id_2> kamar ; <extra_id_3> pelayanan ; <extra_id_4> NULL	a
sangat baik pelayanan nya .	<extra_id_0> pelayanan nya <extra_id_1> sangat baik <extra_id_2> positive	aos
pelayanan sangat buruk . mohon diperbaiki .	<extra_id_0> pelayanan <extra_id_1> sangat buruk <extra_id_2> negative ; <extra_id_3> NULL <extra_id_4> mohon diperbaiki <extra_id_5> negative	aos
pelayanan nya benarbenar ramah , pokok nya tidak nyesal .	<extra_id_0> pelayanan nya ; <extra_id_1> NULL	a
kamar bersih , nyaman , toilet juga bersih , air hangat ada . mungkin bisa dtambah fasilitas gantungan baju .	<extra_id_0> kamar <extra_id_1> bersih ; <extra_id_2> kamar <extra_id_3> nyaman ; <extra_id_4> toilet <extra_id_5> bersih ; <extra_id_6> air hangat <extra_id_7> ada	ao
pas mau breakfast soto madura sudah tidak ada dagingnya sama sekali , kuah juga keasinan , tetapi untung ada pilihan breakfast lainnya .	<extra_id_0> breakfast <extra_id_1> tidak ada dagingnya <extra_id_2> negative	aos
lumayan . sayang ada 1 hari yang kamar tidak di bersihkan dan tidak dapat minuman , dikarenakan tidak adanya pegawai .	<extra_id_0> kamar <extra_id_1> tidak di bersihkan ; <extra_id_2> minuman <extra_id_3> tidak dapat ; <extra_id_4> pegawai <extra_id_5> tidak adanya ; <extra_id_6> NULL <extra_id_7> lumayan	ao
lumayan . harga murmer . fasilitas standar hotel . untuk makanan agak kurang sih tetapi overall good .	<extra_id_0> harga <extra_id_1> murmer <extra_id_2> positive ; <extra_id_3> fasilitas <extra_id_4> standar <extra_id_5> neutral ; <extra_id_6> makanan <extra_id_7> agak kurang <extra_id_8> negative ; <extra_id_9> overall <extra_id_10> good <extra_id_11> positive ; <extra_id_12> NULL <extra_id_13> lumayan <extra_id_14> positive	aos
sangat ramah pelayanannya . dan bersih tempatnya . pokonya nyaman banget deh .	<extra_id_0> pelayanannya <extra_id_1> positive ; <extra_id_2> tempatnya <extra_id_3> positive ; <extra_id_4> NULL <extra_id_5> positive	as
bagus , nyaman , juga keamanan kendaraan tidak buat khawatir . cuma agak perjuangan mencapai lantai 3 he .	<extra_id_0> tidak buat khawatir ; <extra_id_1> bagus ; <extra_id_2> nyaman	o
baru coba airy room yang pertama kali . seprai dan sarung bantal bekas pakai belum dicuci , masih bau iler . lubang septic tank atau entah lubang apa letaknya di bawah kasur , tetapi baunya seperti septic tank .	<extra_id_0> seprai <extra_id_1> negative ; <extra_id_2> sarung bantal <extra_id_3> negative	as
karpet sudah tidak layak . tetapi kamar lumayan nyaman .	<extra_id_0> karpet ; <extra_id_1> kamar	a
kamar nya bersih cuma agak berisik suara mesin air penghangat .	<extra_id_0> kamar nya <extra_id_1> bersih <extra_id_2> positive ; <extra_id_3> mesin air penghangat <extra_id_4> agak berisik <extra_id_5> negative	aos
airy syariahnya bersih , harum , tidak ada bau rokok , cuma ac nya agak ribut .	<extra_id_0> airy ; <extra_id_1> ac nya	a
wangi kamar perlu ditingkatkan lagi .	<extra_id_0> wangi kamar <extra_id_1> negative	as
kamar nya terbilang bagus tetapi sayang perawatan nya kurang , ac nya tidak dingin , disediakan kompor tetapi tidak ada gas dan perlatan memasak dan tidak ada papan reklame airy di depan yang buat saya bingung cari lokasi nya sampai mutarmutar . terimakasih airy .	<extra_id_0> kamar nya ; <extra_id_1> perawatan nya ; <extra_id_2> ac nya	a
kamarnya luas . kalau kebersihan nilainya 3dari 5 .	<extra_id_0> kamarnya	a
murah , nyaman , sinyal tv nya kurang bagus , wifi masih belum stabil , tidak ada keset , remote ac nya suka macet .	<extra_id_0> sinyal tv nya <extra_id_1> kurang bagus ; <extra_id_2> wifi <extra_id_3> belum stabil ; <extra_id_4> keset <extra_id_5> tidak ada ; <extra_id_6> remote ac nya <extra_id_7> macet ; <extra_id_8> NULL <extra_id_9> murah ; <extra_id_10> NULL <extra_id_11> nyaman	ao
nyaman , ac dingin , pelayanan oke .	<extra_id_0> ac <extra_id_1> dingin <extra_id_2> positive ; <extra_id_3> pelayanan <extra_id_4> oke <extra_id_5> positive ; <extra_id_6> NULL <extra_id_7> nyaman <extra_id_8> positive	aos
kemarin pagi pagi airnya kotor , tidak bisa mandi , padahal mau ada acara . katanya ada perbaikan . mungkin masukan perbaikannya dilakukan saat orang tidak butuh air , terimakasih .	<extra_id_0> airnya <extra_id_1> negative	as
pelayanan ramah dan kamar bersih .	<extra_id_0> pelayanan ; <extra_id_1> kamar	a
banyak serangga , akhirnya harus pindah ke deluxe .	<extra_id_0> NULL	a
kamar bersih dan nyaman . lokasi strategis .	<extra_id_0> bersih ; <extra_id_1> nyaman ; <extra_id_2> strategis	o
nyaman , bersih dan penjaga yang ramah .	<extra_id_0> penjaga ; <extra_id_1> NULL	a
kebersihannya kurang , saat masuk banyak hewannya , terutama di kamar mandi . kemudian tempat sampah ada 2 belum dibersihkan , tisu kamar mandi juga kotor belum diganti .	<extra_id_0> kurang ; <extra_id_1> belum dibersihkan ; <extra_id_2> kotor	o
berkesan : bersih , lokasi strategis , murah , ramah , dan dapat peralatan mandi .	<extra_id_0> lokasi <extra_id_1> strategis ; <extra_id_2> peralatan mandi <extra_id_3> dapat ; <extra_id_4> NULL <extra_id_5> bersih ; <extra_id_6> NULL <extra_id_7> murah ; <extra_id_8> NULL <extra_id_9> ramah	ao
hotel yang sangat bagus , akan tetapi kamar mandi saluran airnya tersumbat harap di perbaiki .	<extra_id_0> hotel <extra_id_1> positive ; <extra_id_2> kamar mandi saluran airnya <extra_id_3> negative	as
tempatnya nyaman tetapi kekurangannya disaluran kamar mandi yang mengeluarkan bau kurang sedap .	<extra_id_0> tempatnya <extra_id_1> nyaman <extra_id_2> positive ; <extra_id_3> disaluran kamar mandi <extra_id_4> bau kurang sedap <extra_id_5> negative	aos
kamar cukup bersih dan rapi , saran untuk wc nya bisa di perbaiki lagi .	<extra_id_0> kamar <extra_id_1> cukup bersih <extra_id_2> positive ; <extra_id_3> kamar <extra_id_4> rapi <extra_id_5> positive ; <extra_id_6> wc nya <extra_id_7> bisa di perbaiki lagi <extra_id_8> negative	aos
hotelnya bagus , pelayanan oke , dekat dengan fasilitas umum . terimakasih .	<extra_id_0> hotelnya ; <extra_id_1> pelayanan	a
semua oke untuk harga segitu sih . cuma sayang tidak ada wastafel .	<extra_id_0> oke ; <extra_id_1> tidak ada	o
hotelnya bersih dan lumayan luas kamarnya .	<extra_id_0> hotelnya <extra_id_1> positive ; <extra_id_2> kamarnya <extra_id_3> positive	as
koneksi wifi sangat bagus . akan tetapi , air panas tidak berfungsi .	<extra_id_0> koneksi wifi ; <extra_id_1> air panas	a
kamar paling sempurna dari semua airy yang saya cb di jogja . kamar luas , modern , bersih banget , perfect !	<extra_id_0> kamar <extra_id_1> paling sempurna ; <extra_id_2> kamar <extra_id_3> luas ; <extra_id_4> kamar <extra_id_5> modern ; <extra_id_6> kamar <extra_id_7> bersih banget ; <extra_id_8> kamar <extra_id_9> perfect	ao
dekat akses transportasi .	<extra_id_0> akses transportasi	a
dekat akses transportasi .	<extra_id_0> dekat	o
sangat puas menginap disini .	<extra_id_0> sangat puas	o
tidak sesuai yang ada di gambar .	<extra_id_0> NULL	a
kebersihannya kurang , saat masuk banyak hewannya , terutama di kamar mandi . kemudian tempat sampah ada 2 belum dibersihkan , tisu kamar mandi juga kotor belum diganti .	<extra_id_0> kebersihannya <extra_id_1> kurang <extra_id_2> negative ; <extra_id_3> tempat sampah <extra_id_4> belum dibersihkan <extra_id_5> negative ; <extra_id_6> tisu kamar mandi <extra_id_7> kotor <extra_id_8> negative	aos
tempat transit , makanannya enak .	<extra_id_0> enak	o
ruangan bersih , nyaman .	<extra_id_0> ruangan <extra_id_1> bersih ; <extra_id_2> ruangan <extra_id_3> nyaman	ao
bagus , nyaman , sangat dekat dengan stasiun kereta sawah besar . makanannya standar tetapi . siaran tv nya juga bisa di tambah seharusnya . staf ramah dan membantu . no deposit .	<extra_id_0> makanannya <extra_id_1> standar ; <extra_id_2> staf <extra_id_3> ramah ; <extra_id_4> staf <extra_id_5> membantu ; <extra_id_6> NULL <extra_id_7> bagus ; <extra_id_8> NULL <extra_id_9> nyaman	ao
kamar saya ada kendala di ac tidak berfungsi optimal . dan juga wifi koneksi kurang stabil .	<extra_id_0> ac <extra_id_1> tidak berfungsi optimal <extra_id_2> negative ; <extra_id_3> wifi koneksi <extra_id_4> kurang stabil <extra_id_5> negative	aos
baik . kamar bersih , ac dingin .	<extra_id_0> kamar <extra_id_1> bersih ; <extra_id_2> ac <extra_id_3> dingin ; <extra_id_4> NULL <extra_id_5> baik	ao
keramahan staf hotel ditingkatkan lagi .	<extra_id_0> ditingkatkan lagi	o
murah sih tetapi kamarnya ada yang bocor dan perabotan kotor .	<extra_id_0> kamarnya <extra_id_1> negative ; <extra_id_2> perabotan <extra_id_3> negative ; <extra_id_4> NULL <extra_id_5> positive	as
pelayanannya sudah bagus tetapi kebersihan seprai dan selimutnya tolong ditingkatkan lagi . perhatikan juga tanggal kadaluarsa pada kue yang disediakan di box . terima kasih .	<extra_id_0> pelayanannya <extra_id_1> positive ; <extra_id_2> kebersihan seprai dan selimutnya <extra_id_3> positive	as
tempat nyaman untuk beristirahat , namun perlengkapan mandi yang ada tidak lengkap , hanya ada sabun dan sampo .	<extra_id_0> tempat <extra_id_1> nyaman ; <extra_id_2> perlengkapan mandi <extra_id_3> tidak lengkap	ao
kamarnya minimalis tetapi bersih dan nyaman banget . lokasi juga strategis .	<extra_id_0> kamarnya <extra_id_1> neutral ; <extra_id_2> kamarnya <extra_id_3> positive ; <extra_id_4> lokasi <extra_id_5> positive	as
fasilitasnya kurang bagus dan tidak sesuai kamar airy yang lain yang menyediakan snack dan perlengkapan mandi sesuai standar kamar airy yang ada di hotelhotel lain .	<extra_id_0> fasilitasnya ; <extra_id_1> kamar	a
banyak nyamuk , sinyal tv jelek , tidak ada wifi . wc kotor ada tikus .	<extra_id_0> sinyal tv <extra_id_1> jelek <extra_id_2> negative ; <extra_id_3> wifi <extra_id_4> tidak ada <extra_id_5> negative ; <extra_id_6> wc <extra_id_7> kotor <extra_id_8> negative ; <extra_id_9> wc <extra_id_10> ada tikus <extra_id_11> negative ; <extra_id_12> NULL <extra_id_13> banyak nyamuk <extra_id_14> negative	aos
tempatnya enak , iya walaupun agak masuk gang kecil tetapi mobil masih bisa masuk kok . dekat juga sama malioboro , paling tidak kalau aku ke jogja lagi kayaknya bakal menginap disini lagi .	<extra_id_0> tempatnya <extra_id_1> enak <extra_id_2> positive	aos
tempatnya bagus . kolam renangnya bersih .	<extra_id_0> tempatnya <extra_id_1> bagus ; <extra_id_2> kolam renangnya <extra_id_3> bersih	ao
kebersihan kamar tidak terjaga . tetapi pelayannanya baik .	<extra_id_0> kebersihan kamar <extra_id_1> tidak terjaga ; <extra_id_2> pelayannanya <extra_id_3> baik	ao
cukup bersih meski tanpa sarapan . wifi dan tv perlu pembenahan karena tidak jalan .	<extra_id_0> sarapan <extra_id_1> negative ; <extra_id_2> wifi <extra_id_3> negative ; <extra_id_4> tv <extra_id_5> negative ; <extra_id_6> NULL <extra_id_7> positive	as
menyenangkan , hanya saja tempat tidurnya mungkin sudah lama jadi kasurnya agak turun kebawah begitu . overall good lah iya .	<extra_id_0> kasurnya <extra_id_1> negative ; <extra_id_2> overall <extra_id_3> positive ; <extra_id_4> NULL <extra_id_5> positive	as
terbaik kamar dan kebersihanya .	<extra_id_0> kamar <extra_id_1> terbaik ; <extra_id_2> kebersihanya <extra_id_3> terbaik	ao
ac nya kurang dingin . di laman traveloka gambar kamar mandinya ada bathup nya tetapi pas check in tidak tersedia bathup .	<extra_id_0> kurang dingin ; <extra_id_1> tidak tersedia	o
luar biasa . bagus , bersih , dan termasuk murah dengan fasilitas yang ada , tidak berisik juga , peraturan yang tidak ribet . karyawan nya sopan recommended .	<extra_id_0> peraturan <extra_id_1> tidak ribet ; <extra_id_2> karyawan nya <extra_id_3> sopan ; <extra_id_4> NULL <extra_id_5> luar biasa ; <extra_id_6> NULL <extra_id_7> bagus ; <extra_id_8> NULL <extra_id_9> bersih ; <extra_id_10> NULL <extra_id_11> murah ; <extra_id_12> NULL <extra_id_13> tidak berisik ; <extra_id_14> NULL <extra_id_15> recommended	ao
tempatnya bagus , kamar bersih . pokoknya recommended .	<extra_id_0> tempatnya ; <extra_id_1> kamar ; <extra_id_2> NULL	a
parkirannya tidak aman . helm saya hilang dan tidak ada tanggung jawab dari pihak parkir .	<extra_id_0> parkirannya	a
air asin . kamar kotor . wc kotor .	<extra_id_0> air <extra_id_1> asin <extra_id_2> negative ; <extra_id_3> kamar <extra_id_4> kotor <extra_id_5> negative ; <extra_id_6> wc <extra_id_7> kotor <extra_id_8> negative	aos
lemari rusak , kotor dan berdebu .	<extra_id_0> lemari <extra_id_1> rusak ; <extra_id_2> lemari <extra_id_3> kotor ; <extra_id_4> lemari <extra_id_5> berdebu	ao
kamar besar , luar biasa menyenngkan . tetapi matras kasur murahan alias gemboz , tidak keras .	<extra_id_0> besar ; <extra_id_1> murahan ; <extra_id_2> gemboz ; <extra_id_3> tidak keras	o
air panas di kamar mandi tidak bisa digunakan . air tandon di kloset tidak bisa digunakan sehingga menyiram kloset dengan cara manual . pintu kamar mandi tidak bisa di tutup rapat . kamar mandi kurang bersih .	<extra_id_0> air panas ; <extra_id_1> air tandon ; <extra_id_2> pintu kamar mandi ; <extra_id_3> kamar mandi	a
seprai tidak diganti . banyak pasir .	<extra_id_0> tidak diganti ; <extra_id_1> banyak pasir	o
hotelnya nyaman bersih , tetapi sayang nya tidak dapat sarapan pagi . dan berisik karena dekat rel kereta api .	<extra_id_0> hotelnya <extra_id_1> nyaman <extra_id_2> positive ; <extra_id_3> hotelnya <extra_id_4> bersih <extra_id_5> positive ; <extra_id_6> sarapan pagi <extra_id_7> tidak dapat <extra_id_8> negative ; <extra_id_9> hotelnya <extra_id_10> berisik <extra_id_11> negative	aos
kali ini saya dan suami diberi kamar yang luas dan nyaman seperti di rumah sendiri , ada balkon juga , suka pokoknya .	<extra_id_0> luas ; <extra_id_1> nyaman	o
tempat nyaman , pemandangan indah , pelayanan ramah .	<extra_id_0> tempat <extra_id_1> nyaman ; <extra_id_2> pemandangan <extra_id_3> indah ; <extra_id_4> pelayanan <extra_id_5> ramah	ao
pas dengan harga yang sangat terjangkau , tempat strategis , pelayan pada ramah . cuma sayang kolam renangnya lagi rusak . hu .	<extra_id_0> harga <extra_id_1> positive ; <extra_id_2> tempat <extra_id_3> positive ; <extra_id_4> pelayan <extra_id_5> positive ; <extra_id_6> kolam renangnya <extra_id_7> negative	as
free snack + sabun / sampo airy tidak ada . ac nya juga bocor air nya keluar di dalam ruangan . semoga di perbaiki tempat dan kinerjanya dimana hak buat konsumen .	<extra_id_0> free snack <extra_id_1> negative ; <extra_id_2> sabun <extra_id_3> negative ; <extra_id_4> sampo airy <extra_id_5> negative ; <extra_id_6> ac nya <extra_id_7> negative	as
seperti dirumah sendiri , nyaman dan stafnya ramah . terima kasih .	<extra_id_0> ramah ; <extra_id_1> nyaman	o
kamar hotel luas , no breakfast , no wifi , staf tidak ramah cenderung galak mungkin karena tamu sedikit dan gaji kecil , not recommeded , tidak bakal balik lagi , kamar mandi kecil dan dipisah dengan toilet . aneh .	<extra_id_0> kamar hotel <extra_id_1> positive ; <extra_id_2> breakfast <extra_id_3> negative ; <extra_id_4> wifi <extra_id_5> negative ; <extra_id_6> staf <extra_id_7> negative ; <extra_id_8> kamar mandi <extra_id_9> negative ; <extra_id_10> NULL <extra_id_11> negative	as
handuk dikamar hanya 1 padahal pesan untuk 2 orang , beberapa kali minta ke resepsionis dan room boy tetapi tidak di antar bahkan sampai check out . beberapa fasilitas seperti rak handuk dikamar mandi rusak , pintu kaca sebaiknya ditambahkan gorden atau diganti dengan pintu biasa , kalau siang panas karena kaca . seprai dan bantalnya kotor penuh daki .	<extra_id_0> handuk <extra_id_1> negative ; <extra_id_2> fasilitas <extra_id_3> negative ; <extra_id_4> seprai <extra_id_5> negative ; <extra_id_6> bantalnya <extra_id_7> negative	as
air dikamar mati , mandi dikamar lain . petugas malam kurang ramah dan tidak ringan tangan .	<extra_id_0> air dikamar <extra_id_1> mati <extra_id_2> negative ; <extra_id_3> petugas malam <extra_id_4> kurang ramah <extra_id_5> negative ; <extra_id_6> petugas malam <extra_id_7> tidak ringan tangan <extra_id_8> negative	aos
tempat menginap yang sangat nyaman , kamar bersih . fasilitas lengkap .	<extra_id_0> sangat nyaman ; <extra_id_1> bersih ; <extra_id_2> lengkap	o
peralatan kamar mandi kurang lengkap .	<extra_id_0> kurang lengkap	o
kamarnya bagus , kamad mandinya luas .	<extra_id_0> kamarnya <extra_id_1> bagus <extra_id_2> positive ; <extra_id_3> kamad mandinya <extra_id_4> luas <extra_id_5> positive	aos
recomended , pelayanan memuaskan .	<extra_id_0> pelayanan <extra_id_1> memuaskan ; <extra_id_2> NULL <extra_id_3> recomended	ao
kurang cuma pada sarapan yang cuma di kasih 1 x di hari pertama .	<extra_id_0> sarapan <extra_id_1> kurang	ao
seprai harus di cek , baru atau tidak . yang lainya bagus , khususnya pemandangan mantap .	<extra_id_0> yang lainya ; <extra_id_1> pemandangan	a
sangat buruk , tempat hotel horor , kamar tidak nyaman , setiap lorong suram lampu redup , wifi tidak kencang di lantai 3 .	<extra_id_0> tempat hotel ; <extra_id_1> kamar ; <extra_id_2> lampu ; <extra_id_3> wifi ; <extra_id_4> NULL	a
sangat baik sekali , suasana tenang , tempatnya bersih , kamar tidur empuk , ac dingin , kamar mandi bersih , harga sangat terjangkau , lokasi ditengah kota . sangat puas , recomended sekali !	<extra_id_0> suasana <extra_id_1> tenang <extra_id_2> positive ; <extra_id_3> tempatnya <extra_id_4> bersih <extra_id_5> positive ; <extra_id_6> kamar tidur <extra_id_7> empuk <extra_id_8> positive ; <extra_id_9> ac <extra_id_10> dingin <extra_id_11> positive ; <extra_id_12> kamar mandi <extra_id_13> bersih <extra_id_14> positive ; <extra_id_15> harga <extra_id_16> sangat terjangkau <extra_id_17> positive ; <extra_id_18> NULL <extra_id_19> sangat baik sekali <extra_id_20> positive ; <extra_id_21> NULL <extra_id_22> sangat puas <extra_id_23> positive ; <extra_id_24> NULL <extra_id_25> recomended sekali <extra_id_26> positive	aos
tetap baik dan nyaman . semoga terus berinovasi .	<extra_id_0> NULL	a
fasilitasnya kurang bagus dan tidak sesuai kamar airy yang lain yang menyediakan snack dan perlengkapan mandi sesuai standar kamar airy yang ada di hotelhotel lain .	<extra_id_0> kurang bagus ; <extra_id_1> tidak sesuai	o
tempatnya oke , price sama kualitas pas . suka banget .	<extra_id_0> tempatnya <extra_id_1> oke ; <extra_id_2> price <extra_id_3> pas ; <extra_id_4> kualitas <extra_id_5> pas ; <extra_id_6> NULL <extra_id_7> suka banget	ao
inap kalau mencari ketenangan disini tempanya , recomended .	<extra_id_0> recomended	o
villanya bersih . letaknya strategis dan udaranya dingin . cocok untuk keluarga istirahat menikmati udara sejuk dan jauh dari keramaian .	<extra_id_0> villanya <extra_id_1> bersih <extra_id_2> positive ; <extra_id_3> letaknya <extra_id_4> strategis <extra_id_5> positive ; <extra_id_6> udaranya <extra_id_7> dingin <extra_id_8> positive	aos
pada awal saya masuk kamar bau rokok . kemudian saya masuk kamar mandi , di toilet nya ada tinja yang muncul mungkin tersumbat salurannya sehingga naik ke atas . akhirnya saya flash dan bau sekali . kemudian saya menyalakan tv , tetapi tv tidak keluar gambar .	<extra_id_0> bau rokok ; <extra_id_1> tidak keluar gambar ; <extra_id_2> bau sekali	o
stafnya ramah . kamar cukup bersih . sayang sewaktu bermalam terganggu suara toa dan tidak tersedia tisu di kamar .	<extra_id_0> ramah ; <extra_id_1> cukup bersih ; <extra_id_2> tidak tersedia	o
sarapan pagi standar .	<extra_id_0> standar	o
cukup baik tetapi wc nya kurang nyaman .	<extra_id_0> wc nya ; <extra_id_1> NULL	a
menyenangkan sekali bisa liburan bersama keluarga dan menginap di airy .	<extra_id_0> NULL <extra_id_1> menyenangkan sekali	ao
karyawan kurang ramah dan kurang baik .	<extra_id_0> karyawan <extra_id_1> kurang ramah ; <extra_id_2> karyawan <extra_id_3> kurang baik	ao
hanya saja kalau bawa mobil parkirnya susah .	<extra_id_0> parkirnya <extra_id_1> susah <extra_id_2> negative	aos
oke banget suka dengan servis nya , sopan dan memuaskan .	<extra_id_0> oke banget ; <extra_id_1> suka ; <extra_id_2> memuaskan ; <extra_id_3> sopan	o
tingkatkan kebersihan seprai kasur dan bantal serta selimut . terima kasih .	<extra_id_0> seprai <extra_id_1> negative ; <extra_id_2> kasur <extra_id_3> negative ; <extra_id_4> bantal <extra_id_5> negative ; <extra_id_6> selimut <extra_id_7> negative	as
kamarnya horor , kurang bersih .	<extra_id_0> horor ; <extra_id_1> kurang bersih	o
fasilitas oke kebersihan terjaga . menu sarapan enak .	<extra_id_0> fasilitas <extra_id_1> oke ; <extra_id_2> kebersihan <extra_id_3> terjaga ; <extra_id_4> menu sarapan <extra_id_5> enak	ao
kamar cukup luas , interior menarik dan unik sekali , penempatan furniture tepat , suka banget dengan kamar mandinya , walpaper kamar beragam , pencahayaan dibuat dramatis , tidak terlalu terang tetapi baguss . hanya saja tidak tersedia sarapan , naik ke lantai 1 dengan tangga , lift tidak berfungsi .	<extra_id_0> kamar <extra_id_1> cukup luas <extra_id_2> positive ; <extra_id_3> interior <extra_id_4> menarik <extra_id_5> positive ; <extra_id_6> interior <extra_id_7> unik sekali <extra_id_8> positive ; <extra_id_9> kamar mandinya <extra_id_10> suka banget <extra_id_11> positive ; <extra_id_12> pencahayaan <extra_id_13> dramatis <extra_id_14> positive ; <extra_id_15> pencahayaan <extra_id_16> tidak terlalu terang <extra_id_17> neutral ; <extra_id_18> pencahayaan <extra_id_19> baguss <extra_id_20> negative ; <extra_id_21> sarapan <extra_id_22> tidak tersedia <extra_id_23> negative ; <extra_id_24> lift <extra_id_25> tidak berfungsi <extra_id_26> negative	aos
bersih . luas .	<extra_id_0> NULL	a
kedatangan yang kedua dengan harga lebih mahal tetapi seprai sngat kotor . saya minta tolong diganti tetapi katnya tidak ada lagi sprainya dna tidak tahu taro dmna ? saya minta ganti kamar dibilangnya penuh . selain seprai kotor lantai juga kotor .	<extra_id_0> seprai <extra_id_1> sngat kotor <extra_id_2> negative ; <extra_id_3> seprai <extra_id_4> kotor <extra_id_5> negative ; <extra_id_6> lantai <extra_id_7> kotor <extra_id_8> negative	aos
sangat merekomendasikan , tempatnya memuaskan .	<extra_id_0> tempatnya ; <extra_id_1> NULL	a
sarapan nya untuk lauknya porsinya terlalu sedikit , saluran televisi tidak jelas dan buram , untuk kondisi kamar bersih dan bagus .	<extra_id_0> sarapan nya <extra_id_1> terlalu sedikit ; <extra_id_2> saluran televisi <extra_id_3> tidak jelas ; <extra_id_4> saluran televisi <extra_id_5> buram ; <extra_id_6> kamar <extra_id_7> bersih ; <extra_id_8> kamar <extra_id_9> bagus	ao
kamar kotor bau , ada bekas handuk orng ( kamar gavdi bersihkan ) , banyak kecoak dan nyamuk , ranjang kotor , pesan yang 1 ranjang besar di kasih yang twin bed , kamar mandi jorok ada bekas darah orang , susah sinyal , harus ke cafe baru dpet wifi , sry saya jujurjujur saja bukan di buatbuat , terimakasih .	<extra_id_0> kotor ; <extra_id_1> bau ; <extra_id_2> jorok ; <extra_id_3> susah sinyal	o
menyenangkan sekali bisa liburan bersama keluarga dan menginap di airy .	<extra_id_0> NULL <extra_id_1> positive	as
letak hotel strategis .	<extra_id_0> letak hotel <extra_id_1> strategis <extra_id_2> positive	aos
kamar luas dan kedap , bersih makanan enak . dan lokasi strategis .	<extra_id_0> kamar <extra_id_1> luas <extra_id_2> positive ; <extra_id_3> kamar <extra_id_4> kedap <extra_id_5> positive ; <extra_id_6> kamar <extra_id_7> bersih <extra_id_8> positive ; <extra_id_9> makanan <extra_id_10> enak <extra_id_11> positive ; <extra_id_12> lokasi <extra_id_13> strategis <extra_id_14> positive	aos
sangat nyaman dan bagus .	<extra_id_0> NULL <extra_id_1> sangat nyaman <extra_id_2> positive ; <extra_id_3> NULL <extra_id_4> bagus <extra_id_5> positive	aos
nyaman bersih pelayanannya memuaskan . untuk debit air showernya lebih ditingkatkan lagi : ) .	<extra_id_0> memuaskan ; <extra_id_1> lebih ditingkatkan lagi ; <extra_id_2> nyaman ; <extra_id_3> bersih	o
pelayanan nya sangat bagus tetapi kamar nya kurang bersih agak sedikit bau dan seperti wisma .	<extra_id_0> pelayanan nya <extra_id_1> sangat bagus ; <extra_id_2> kamar nya <extra_id_3> kurang bersih ; <extra_id_4> kamar nya <extra_id_5> agak sedikit bau	ao
pelayanan yang sangat baik kamar sesuai .	<extra_id_0> sangat baik ; <extra_id_1> sesuai	o
kamar bersih semua perlengkapan tersedia .	<extra_id_0> kamar ; <extra_id_1> perlengkapan	a
sarapan lumayan enak .	<extra_id_0> sarapan <extra_id_1> positive	as
semuanya bagus hanya saja orang merokok di luar ruangan asapnya masih tercium sampai dalam kamar .	<extra_id_0> semuanya <extra_id_1> positive	as
nyman banget mantap ! recommended .	<extra_id_0> NULL <extra_id_1> nyman banget <extra_id_2> positive ; <extra_id_3> NULL <extra_id_4> mantap <extra_id_5> positive ; <extra_id_6> NULL <extra_id_7> recommended <extra_id_8> positive	aos
kamarnya sangat bagus dengan harga yang murah . sangat menyenangkan untuk menginap di sini .	<extra_id_0> sangat bagus ; <extra_id_1> murah ; <extra_id_2> sangat menyenangkan	o
ruanganya sangat bersih , rapi dan tata ruang . buat tidak mau beranjak dari kamar . amat sangat rekomended .	<extra_id_0> ruanganya <extra_id_1> sangat bersih <extra_id_2> positive ; <extra_id_3> ruanganya <extra_id_4> rapi <extra_id_5> positive ; <extra_id_6> NULL <extra_id_7> sangat rekomended <extra_id_8> positive	aos
direkomendasikan untuk kelas budget .	<extra_id_0> NULL <extra_id_1> direkomendasikan <extra_id_2> positive	aos
sarapan rasa standar .	<extra_id_0> standar	o
murah recommended booking pakai airy jauh lebih murah .	<extra_id_0> murah ; <extra_id_1> recommended	o
enak dapat sarapan bubur ayam . walau kamar mandi sempit , tetapi cukup dan bersih .	<extra_id_0> kamar mandi <extra_id_1> sempit ; <extra_id_2> kamar mandi <extra_id_3> cukup ; <extra_id_4> kamar mandi <extra_id_5> bersih ; <extra_id_6> NULL <extra_id_7> enak	ao
oke hanya ac kurang dingin .	<extra_id_0> ac <extra_id_1> kurang dingin ; <extra_id_2> NULL <extra_id_3> oke	ao
fasilatas sesuia .	<extra_id_0> fasilatas <extra_id_1> sesuia <extra_id_2> positive	aos
tempat nya seram dan pelayanan kurang ramah .	<extra_id_0> tempat nya ; <extra_id_1> pelayanan	a
menginap 4 hari disini sangat menyenangkan .	<extra_id_0> sangat menyenangkan	o
tempatnya nyaman , akses mudah , harga terjangkau .	<extra_id_0> tempatnya ; <extra_id_1> akses ; <extra_id_2> harga	a
nyaman bersih pelayanan oke .	<extra_id_0> oke ; <extra_id_1> nyaman ; <extra_id_2> bersih	o
kamarnya sesuai budget namun ac nya agak berisik . semoga kedepannya lebih baik lagi .	<extra_id_0> sesuai ; <extra_id_1> agak berisik	o
layanan baik tempat bersih .	<extra_id_0> layanan <extra_id_1> baik ; <extra_id_2> tempat <extra_id_3> bersih	ao
hotelnya mewah dan bersih , makanannya enak , akses kelokasi perbelanjaan dan hiburan sangat mudah . catatan : harus menunggu beberapa saat untuk check in karena kamarnya belum disiapkan .	<extra_id_0> hotelnya <extra_id_1> mewah <extra_id_2> positive ; <extra_id_3> hotelnya <extra_id_4> bersih <extra_id_5> positive ; <extra_id_6> makanannya <extra_id_7> enak <extra_id_8> positive ; <extra_id_9> akses <extra_id_10> sangat mudah <extra_id_11> positive	aos
perlu ditambah pengharum di lemarinya . overall kamarnya bersih banget , nyaman , fasilitas lengkap , ac dingin . kalau bisa sediakan line telepon untuk pemesanan taksi , karena letaknya cukup jauh dari jalan raya .	<extra_id_0> overall kamarnya <extra_id_1> positive ; <extra_id_2> fasilitas <extra_id_3> positive ; <extra_id_4> ac <extra_id_5> positive ; <extra_id_6> letaknya <extra_id_7> negative	as
kamar mandi bau dan pintu kamar mandi rusak . banyak nyamuk .	<extra_id_0> kamar mandi <extra_id_1> bau <extra_id_2> negative ; <extra_id_3> pintu kamar mandi <extra_id_4> rusak <extra_id_5> negative ; <extra_id_6> pintu kamar mandi <extra_id_7> banyak nyamuk <extra_id_8> negative	aos
saya biasa menginap di airy , tetapi kali ini untuk resepsionis hotel nya tidak ramah .	<extra_id_0> resepsionis hotel nya <extra_id_1> tidak ramah <extra_id_2> negative	aos
kamarnya luas , pegawainya ramahramah sekali dan sangat membantu . lokasinya juga dekat kalau mau pergi kemanakemana . sarapannya juga enak , puas sekali menginap disini . kalau ke cirebon lagi pasti bakal balik lagi inap disini .	<extra_id_0> kamarnya <extra_id_1> positive ; <extra_id_2> pegawainya <extra_id_3> positive ; <extra_id_4> sarapannya <extra_id_5> positive ; <extra_id_6> menginap <extra_id_7> positive	as
ruangan cukup luas . suka sama pintu kamar mandinya .	<extra_id_0> ruangan <extra_id_1> cukup luas ; <extra_id_2> pintu kamar mandinya <extra_id_3> suka	ao
kamarnya kotor , tidak ada tisu dan tempat sampah . lampu tidur dikamar juga mati , selimutnya hanya setengah badan saja .	<extra_id_0> kotor ; <extra_id_1> tidak ada ; <extra_id_2> mati ; <extra_id_3> hanya setengah badan	o
kamar nyaman .	<extra_id_0> kamar <extra_id_1> nyaman <extra_id_2> positive	aos
tempat strategis dan sangat nyaman membuat liburan di jogja menjadi menyenangkan .	<extra_id_0> tempat	a
temapatnya oke .	<extra_id_0> temapatnya	a
tempat bersih , petugas ramah dan cantik .	<extra_id_0> bersih ; <extra_id_1> ramah ; <extra_id_2> cantik	o
bersih rapi pelayana ramah , parkir mudah .	<extra_id_0> pelayana <extra_id_1> ramah ; <extra_id_2> parkir <extra_id_3> mudah ; <extra_id_4> NULL <extra_id_5> bersih ; <extra_id_6> NULL <extra_id_7> rapi	ao
pelayanan dan segalanya baik .	<extra_id_0> baik	o
kamar nyaman , bersih , rapi , petugasnya juga ramah , makanannya lumayan enak .	<extra_id_0> kamar <extra_id_1> positive ; <extra_id_2> petugasnya <extra_id_3> positive ; <extra_id_4> makanannya <extra_id_5> positive	as
tempatnya nyaman dan bersih ditambah suasanya menyenangkan . recomandat lah . terimakasih .	<extra_id_0> nyaman ; <extra_id_1> bersih ; <extra_id_2> menyenangkan ; <extra_id_3> recomandat	o
untuk backpacker sangat bagus . cuma penjaga nya tidak mau buka pintu kalau pulang lewat dari jam 11 malam .	<extra_id_0> NULL <extra_id_1> positive	as
nyaman . bersih . lokasi terjangkau .	<extra_id_0> terjangkau ; <extra_id_1> nyaman ; <extra_id_2> bersih	o
air hangat tidak hidup didalam kamar mandi .	<extra_id_0> air hangat <extra_id_1> negative	as
wifi nya palsu . air panas nya rusak .	<extra_id_0> wifi nya ; <extra_id_1> air panas nya	a
bersih dan nyaman .	<extra_id_0> NULL <extra_id_1> bersih ; <extra_id_2> NULL <extra_id_3> nyaman	ao
kamar luas , bersih , lokasi dekat dengan pusat perbelanjaan dan kuliner , pokoknya recommended .	<extra_id_0> kamar <extra_id_1> luas ; <extra_id_2> kamar <extra_id_3> bersih ; <extra_id_4> NULL <extra_id_5> recommended	ao
sarapan nya untuk lauknya porsinya terlalu sedikit , saluran televisi tidak jelas dan buram , untuk kondisi kamar bersih dan bagus .	<extra_id_0> sarapan nya <extra_id_1> negative ; <extra_id_2> saluran televisi <extra_id_3> negative ; <extra_id_4> kamar <extra_id_5> positive	as
